"","Stu_ProgramCIPCodeChange","Stu_CollegeChange","Stu_TotalUniversityHoursBegin","Stu_DepartmentChange","Stu_TotalUniversityHours1","Year1_crd","Stu_TotalUniversityHours2","Year2_crd","Stu_TotalUniversityHours3","Year3_crd","Stu_TotalInstHours1","Stu_TotalInstHours2","Stu_TotalInstHours3","Stu_Department3","Stu_Gender","Stu_Ethnicity","Stu_InstitutionalGPA3","HoursDWFCount3","Deg_CollegeCode","Deg_Depar.Code","Gradu_Code"
"1","No","No",13,"No",29,16,61,32,91,30,29,61,91,"ECE","Male","NoWhite",3.0835,3,"HMCSE","ECE","OverTime"
"2","No","No",13,"No",29,16,61,32,91,30,29,61,91,"ECE","Male","NoWhite",3.0835,3,"HMCSE","ECE","OverTime"
"3","Yes","No",36,"Yes",47,11,77,30,105,28,28,54,89,"NoECE","Male","White",3.04,7,"HMCSE","NoECE","OnTime"
"4","No","No",45,"Yes",61,16,87,26,96,9,29,55,64,"NoECE","Female","White",3.0397,9,"HMCSE","NoECE","OverTime"
"5","Yes","No",78,"Yes",90,12,110,20,142,32,26,54,86,"ECE","Male","White",3.6506,0,"HMCSE","NoECE","OnTime"
"6","No","No",14,"Yes",26,12,53,27,74,21,26,44,72,"NoECE","Female","White",2.7273,3,"HMCSE","NoECE","OverTime"
"7","No","No",37,"No",51,14,78,27,108,30,26,53,83,"NoECE","Male","NoWhite",3.6843,0,"HMCSE","NoECE","OnTime"
"8","No","No",54,"No",67,13,111,44,145,34,26,58,92,"NoECE","Male","White",3.262,1,"HMCSE","NoECE","OnTime"
"9","Yes","No",11,"Yes",62,51,87,25,108,21,33,61,86,"NoECE","Male","NoWhite",2.4349,21,"HMCSE","NoECE","OverTime"
"10","No","No",21,"No",37,16,60,23,98,38,27,52,83,"NoECE","Male","White",3.0747,4,"HMCSE","NoECE","OverTime"
"11","Yes","No",21,"Yes",34,13,62,28,89,27,26,54,75,"NoECE","Female","NoWhite",3.08,4,"HMCSE","NoECE","OverTime"
"12","Yes","No",6,"No",30,24,49,19,68,19,30,54,80,"NoECE","Male","NoWhite",2.0638,30,"HMCSE","NoECE","OverTime"
"13","Yes","No",16,"Yes",32,16,64,32,101,37,29,58,95,"NoECE","Female","NoWhite",3.4316,3,"HMCSE","NoECE","OnTime"
"14","No","No",17,"No",36,19,65,29,102,37,30,58,88,"NoECE","Female","White",3.2516,0,"HMCSE","NoECE","OnTime"
"15","No","No",14,"No",32,18,57,25,95,38,32,57,86,"NoECE","Male","NoWhite",3.0633,3,"HMCSE","NoECE","OnTime"
"16","Yes","No",26,"Yes",45,19,56,11,67,11,33,51,62,"ECE","Female","White",2.6577,14,"HMCSE","ECE","OverTime"
"17","No","No",22,"Yes",50,28,81,31,116,35,28,59,94,"ECE","Male","White",3.7093,0,"HMCSE","ECE","OnTime"
"18","No","No",30,"Yes",54,24,84,30,121,37,36,66,103,"NoECE","Male","NoWhite",3.5037,3,"HMCSE","NoECE","OnTime"
"19","No","No",16,"No",32,16,58,26,81,23,32,58,78,"ECE","Male","White",2.6551,11,"HMCSE","ECE","OverTime"
"20","No","No",19,"Yes",32,13,42,10,86,44,26,39,79,"NoECE","Female","NoWhite",3.1471,9,"HMCSE","NoECE","OverTime"
"21","No","No",12,"No",32,20,66,34,96,30,32,62,92,"NoECE","Male","White",3.8152,0,"HMCSE","NoECE","OverTime"
"22","No","No",12,"No",25,13,38,13,78,40,25,38,81,"ECE","Female","NoWhite",2.9936,7,"HMCSE","ECE","OverTime"
"23","No","No",12,"No",25,13,38,13,78,40,25,38,81,"ECE","Female","NoWhite",2.9936,7,"HMCSE","ECE","OverTime"
"24","Yes","No",31,"Yes",57,26,88,31,134,46,26,59,100,"NoECE","Female","NoWhite",3.5284,3,"HMCSE","NoECE","OnTime"
"25","No","No",77,"No",100,23,132,32,146,14,37,63,77,"NoECE","Female","White",3.0974,0,"HMCSE","NoECE","OnTime"
"26","Yes","No",39,"No",51,12,65,14,92,27,23,39,63,"ECE","Male","NoWhite",2.6063,10,"HMCSE","ECE","OverTime"
"27","Yes","No",25,"Yes",42,17,68,26,83,15,26,56,71,"NoECE","Male","White",3.1458,0,"HMCSE","NoECE","OnTime"
"28","Yes","Yes",75,"Yes",85,10,98,13,122,24,24,44,68,"NoECE","Male","White",2.0279,27,"NoHMCSE","NoECE","OverTime"
"29","Yes","No",36,"Yes",52,16,74,22,101,27,30,51,78,"ECE","Male","White",2.9253,16,"HMCSE","ECE","OverTime"
"30","No","No",72,"No",85,13,117,32,144,27,25,57,84,"NoECE","Female","White",3.775,0,"HMCSE","NoECE","OnTime"
"31","No","No",43,"Yes",69,26,89,20,114,25,34,54,79,"NoECE","Male","White",3.9143,0,"HMCSE","NoECE","OnTime"
"32","Yes","No",12,"Yes",31,19,54,23,79,25,31,58,83,"NoECE","Male","NoWhite",2.8675,14,"HMCSE","NoECE","OverTime"
"33","No","No",34,"No",54,20,89,35,119,30,36,71,101,"NoECE","Male","NoWhite",3.0267,8,"HMCSE","NoECE","OnTime"
"34","No","No",45,"No",71,26,97,26,127,30,42,68,97,"NoECE","Female","White",3.7443,13,"HMCSE","NoECE","OnTime"
"35","No","No",18,"Yes",33,15,54,21,73,19,27,55,70,"NoECE","Male","NoWhite",2.6071,17,"HMCSE","NoECE","OverTime"
"36","No","No",75,"No",87,12,119,32,135,16,24,48,64,"NoECE","Female","White",3.1013,0,"HMCSE","NoECE","OnTime"
"37","No","No",10,"Yes",24,14,65,41,95,30,14,55,85,"NoECE","Female","White",3.8705,0,"HMCSE","NoECE","OnTime"
"38","No","No",83,"No",94,11,113,19,137,24,35,59,83,"NoECE","Male","White",2.7024,21,"HMCSE","NoECE","OnTime"
"39","No","No",12,"No",36,24,68,32,100,32,28,60,95,"ECE","Male","White",3.3074,11,"HMCSE","ECE","OverTime"
"40","Yes","No",38,"Yes",58,20,94,36,127,33,36,72,105,"NoECE","Male","White",3.3343,5,"HMCSE","NoECE","OverTime"
"41","No","No",21,"Yes",50,29,79,29,114,35,29,58,93,"NoECE","Male","White",3.3848,0,"HMCSE","NoECE","OnTime"
"42","No","No",32,"No",46,14,75,29,109,34,28,54,81,"NoECE","Female","White",3.26,0,"HMCSE","NoECE","OverTime"
"43","No","No",15,"No",27,12,50,23,84,34,27,50,84,"NoECE","Male","NoWhite",3.2095,7,"HMCSE","NoECE","OverTime"
"44","No","No",43,"No",57,14,85,28,117,32,27,55,87,"NoECE","Female","White",3.508,0,"HMCSE","NoECE","OnTime"
"45","No","No",39,"No",52,13,71,19,93,22,26,51,77,"NoECE","Male","NoWhite",2.9523,10,"HMCSE","NoECE","OnTime"
"46","No","No",15,"Yes",25,10,39,14,78,39,31,45,53,"NoECE","Male","NoWhite",2.0979,21,"HMCSE","NoECE","OverTime"
"47","No","No",42,"Yes",57,15,101,44,131,30,15,59,86,"NoECE","Female","White",3.5484,0,"HMCSE","NoECE","OnTime"
"48","No","No",13,"Yes",35,22,64,29,93,29,26,58,87,"NoECE","Female","White",3.5144,0,"HMCSE","NoECE","OverTime"
"49","No","No",12,"Yes",24,12,51,27,70,19,24,51,76,"NoECE","Male","White",2.9178,22,"HMCSE","NoECE","OverTime"
"50","Yes","No",22,"Yes",38,16,66,28,77,11,32,60,80,"ECE","Male","White",2.5975,22,"HMCSE","NoECE","OverTime"
"51","No","No",17,"No",31,14,44,13,69,25,27,40,65,"ECE","Male","White",3.1415,0,"HMCSE","ECE","OverTime"
"52","No","No",19,"No",32,13,68,36,117,49,26,56,86,"NoECE","Male","White",3.325,3,"HMCSE","NoECE","OnTime"
"53","Yes","Yes",6,"Yes",43,37,83,40,117,34,43,83,117,"NoECE","Female","NoWhite",3.059,15,"NoHMCSE","NoECE","OnTime"
"54","No","No",54,"No",70,16,94,24,120,26,29,49,78,"ECE","Male","White",2.6474,19,"HMCSE","ECE","OverTime"
"55","No","No",37,"Yes",51,14,55,4,49,-6,27,31,25,"NoECE","Male","NoWhite",3.0105,7,"HMCSE","NoECE","OverTime"
"56","Yes","Yes",68,"Yes",82,14,124,42,161,37,27,69,106,"NoECE","Female","White",3.7233,10,"NoHMCSE","NoECE","OverTime"
"57","No","No",41,"No",59,18,91,32,111,20,31,63,83,"NoECE","Female","NoWhite",3.8203,15,"HMCSE","NoECE","OverTime"
"58","Yes","No",10,"No",22,12,47,25,74,27,22,47,74,"NoECE","Male","White",2.3662,21,"HMCSE","NoECE","OverTime"
"59","No","No",32,"No",49,17,81,32,114,33,30,62,95,"ECE","Male","NoWhite",3.4737,4,"HMCSE","ECE","OverTime"
"60","No","No",13,"No",52,39,88,36,124,36,45,81,114,"NoECE","Male","NoWhite",3.4188,0,"HMCSE","NoECE","OnTime"
"61","No","No",61,"Yes",85,24,119,34,138,19,24,58,77,"NoECE","Male","NoWhite",3.3674,0,"HMCSE","NoECE","OnTime"
"62","Yes","No",28,"Yes",44,16,65,21,83,18,22,46,64,"NoECE","Male","White",3.6271,13,"HMCSE","NoECE","OnTime"
"63","No","No",17,"No",34,17,68,34,97,29,31,65,94,"NoECE","Male","White",3.2926,0,"HMCSE","NoECE","OnTime"
"64","Yes","Yes",56,"Yes",80,24,115,35,135,20,38,72,92,"NoECE","Female","White",2.9804,9,"HMCSE","NoECE","OnTime"
"65","No","No",12,"No",24,12,49,25,73,24,24,49,73,"NoECE","Male","NoWhite",2.7603,12,"HMCSE","NoECE","OverTime"
"66","Yes","No",37,"Yes",50,13,77,27,102,25,27,54,78,"NoECE","Female","White",3.6731,0,"HMCSE","NoECE","OnTime"
"67","Yes","Yes",43,"Yes",77,34,115,38,138,23,39,77,100,"NoECE","Female","White",2.549,27,"NoHMCSE","NoECE","OverTime"
"68","No","No",6,"No",18,12,50,32,75,25,18,47,76,"NoECE","Male","White",2.9819,25,"HMCSE","NoECE","OverTime"
"69","Yes","No",3,"Yes",28,25,49,21,81,32,28,52,74,"ECE","Male","White",2.7825,17,"HMCSE","NoECE","OverTime"
"70","No","No",21,"No",34,13,65,31,92,27,25,56,82,"NoECE","Male","White",3.1305,8,"HMCSE","NoECE","OnTime"
"71","No","No",13,"No",36,23,72,36,110,38,36,72,110,"NoECE","Male","White",3.4636,3,"HMCSE","NoECE","OnTime"
"72","No","No",20,"Yes",40,20,65,25,79,14,33,62,78,"NoECE","Female","White",2.7543,10,"HMCSE","NoECE","OverTime"
"73","Yes","No",12,"Yes",31,19,65,34,100,35,31,65,100,"NoECE","Male","White",2.851,13,"HMCSE","NoECE","OverTime"
"74","No","No",50,"Yes",63,13,88,25,112,24,27,52,76,"ECE","Male","NoWhite",3.5392,0,"HMCSE","ECE","OverTime"
"75","Yes","No",23,"Yes",39,16,56,17,89,33,26,51,87,"ECE","Male","NoWhite",2.733,10,"HMCSE","NoECE","OverTime"
"76","No","No",53,"No",79,26,107,28,138,31,39,67,98,"ECE","Male","White",3.0878,5,"HMCSE","ECE","OnTime"
"77","No","No",45,"Yes",75,30,108,33,111,3,30,63,66,"NoECE","Female","White",3.2012,0,"HMCSE","NoECE","OnTime"
"78","Yes","No",19,"No",35,16,64,29,92,28,31,64,92,"ECE","Male","NoWhite",3.0489,6,"HMCSE","ECE","OverTime"
"79","No","No",19,"No",36,17,66,30,84,18,30,60,81,"ECE","Male","White",3.0987,10,"HMCSE","ECE","OverTime"
"80","No","No",26,"Yes",46,20,72,26,101,29,28,60,89,"NoECE","Female","White",2.8978,0,"HMCSE","NoECE","OnTime"
"81","No","No",23,"No",45,22,79,34,108,29,36,70,99,"NoECE","Male","White",3.1818,7,"HMCSE","NoECE","OverTime"
"82","No","No",24,"Yes",37,13,64,27,95,31,27,53,84,"NoECE","Male","White",3.3521,3,"HMCSE","NoECE","OnTime"
"83","No","No",18,"No",44,26,77,33,110,33,29,62,89,"ECE","Male","White",3.4411,0,"HMCSE","ECE","OverTime"
"84","Yes","No",31,"Yes",44,13,71,27,88,17,25,48,68,"NoECE","Male","White",2.9868,13,"HMCSE","NoECE","OverTime"
"85","Yes","No",15,"Yes",28,13,66,38,106,40,13,51,87,"NoECE","Male","NoWhite",3.3143,0,"HMCSE","NoECE","OnTime"
"86","No","No",16,"Yes",29,13,61,32,75,14,26,54,72,"NoECE","Male","White",2.4125,11,"HMCSE","NoECE","OverTime"
"87","No","No",27,"Yes",54,27,81,27,112,31,27,54,85,"ECE","Male","White",3.4875,0,"HMCSE","ECE","OnTime"
"88","No","No",20,"Yes",48,28,76,28,83,7,31,58,72,"ECE","Male","White",3.1459,7,"HMCSE","ECE","OverTime"
"89","No","No",20,"Yes",48,28,76,28,83,7,31,58,72,"ECE","Male","White",3.1459,7,"HMCSE","ECE","OverTime"
"90","No","No",70,"No",106,36,134,28,156,22,100,134,155,"NoECE","Male","White",3.7641,0,"HMCSE","NoECE","OnTime"
"91","No","No",70,"No",106,36,134,28,156,22,100,134,155,"NoECE","Male","White",3.7641,0,"HMCSE","NoECE","OnTime"
"92","No","No",71,"No",95,24,122,27,141,19,40,67,86,"NoECE","Male","White",3.2,3,"HMCSE","NoECE","OnTime"
"93","Yes","Yes",25,"Yes",42,17,62,20,66,4,30,54,62,"ECE","Female","White",2.4371,13,"NoHMCSE","NoECE","OverTime"
"94","No","No",40,"No",61,21,95,34,125,30,34,68,98,"NoECE","Male","White",3.8594,6,"HMCSE","NoECE","OnTime"
"95","No","No",40,"No",61,21,95,34,125,30,34,68,98,"NoECE","Male","White",3.8594,6,"NoHMCSE","NoECE","OnTime"
"96","No","No",14,"No",36,22,68,32,100,32,33,65,97,"NoECE","Female","White",2.933,7,"HMCSE","NoECE","OverTime"
"97","No","No",13,"No",29,16,64,35,94,30,29,64,94,"NoECE","Female","White",3.6936,0,"HMCSE","NoECE","OnTime"
"98","No","No",39,"Yes",52,13,79,27,110,31,27,54,85,"ECE","Male","White",3.4813,0,"HMCSE","ECE","OnTime"
"99","No","No",13,"Yes",13,0,47,34,67,20,13,40,60,"NoECE","Female","White",3.0295,0,"HMCSE","NoECE","OverTime"
"100","No","No",76,"No",88,12,127,39,139,12,27,51,67,"NoECE","Female","White",3.606,0,"HMCSE","NoECE","OnTime"
"101","No","No",20,"No",35,15,60,25,90,30,28,53,82,"NoECE","Female","White",3.1,4,"HMCSE","NoECE","OnTime"
"102","Yes","Yes",9,"Yes",26,17,40,14,76,36,32,46,85,"NoECE","Female","NoWhite",2.0976,35,"NoHMCSE","NoECE","OverTime"
"103","No","No",13,"No",25,12,56,31,90,34,25,56,90,"NoECE","Male","NoWhite",3.34,0,"HMCSE","NoECE","OnTime"
"104","No","No",43,"No",63,20,92,29,117,25,33,62,86,"NoECE","Male","NoWhite",3.4151,0,"HMCSE","NoECE","OnTime"
"105","No","No",18,"No",30,12,61,31,81,20,24,55,75,"NoECE","Female","White",3.072,14,"HMCSE","NoECE","OverTime"
"106","No","No",19,"No",38,19,65,27,100,35,31,58,93,"NoECE","Female","White",3.1872,10,"HMCSE","NoECE","OverTime"
"107","No","No",28,"No",44,16,73,29,109,36,29,58,94,"NoECE","Female","White",3.3957,0,"HMCSE","NoECE","OnTime"
"108","No","No",33,"No",52,19,80,28,112,32,32,60,88,"ECE","Male","White",3.2474,3,"HMCSE","ECE","OnTime"
"109","No","No",48,"No",59,11,89,30,115,26,29,55,85,"NoECE","Female","White",2.7079,19,"HMCSE","NoECE","OnTime"
"110","Yes","No",40,"Yes",57,17,76,19,103,27,28,55,84,"NoECE","Female","NoWhite",2.806,25,"HMCSE","NoECE","OverTime"
"111","Yes","No",14,"No",24,10,44,20,73,29,24,47,70,"NoECE","Female","White",2.7865,19,"HMCSE","NoECE","OverTime"
"112","Yes","Yes",52,"Yes",72,20,91,19,116,25,29,53,82,"NoECE","Female","White",2.5835,26,"HMCSE","NoECE","OnTime"
"113","Yes","No",56,"Yes",75,19,100,25,122,22,27,56,78,"NoECE","Female","White",3.9044,0,"HMCSE","NoECE","OnTime"
"114","Yes","No",10,"Yes",20,10,40,20,69,29,20,49,69,"NoECE","Female","White",3.0812,24,"HMCSE","NoECE","OverTime"
"115","Yes","No",75,"No",93,18,124,31,150,26,44,75,101,"ECE","Male","White",3.749,6,"HMCSE","ECE","OnTime"
"116","Yes","No",28,"Yes",54,26,81,27,108,27,26,53,80,"NoECE","Female","NoWhite",3.7929,0,"HMCSE","NoECE","OnTime"
"117","No","No",36,"Yes",49,13,68,19,68,0,49,73,73,"ECE","Male","White",3.0068,17,"HMCSE","ECE","OverTime"
"118","No","No",41,"No",58,17,92,34,131,39,30,64,103,"NoECE","Male","White",3.5816,0,"HMCSE","NoECE","OnTime"
"119","No","No",25,"No",43,18,71,28,95,24,31,59,81,"NoECE","Female","White",3.2181,8,"HMCSE","NoECE","OverTime"
"120","No","No",12,"Yes",27,15,51,24,63,12,27,55,76,"NoECE","Male","White",2.9014,24,"HMCSE","NoECE","OverTime"
"121","No","No",15,"No",30,15,62,32,90,28,30,62,90,"NoECE","Male","NoWhite",3.9567,0,"HMCSE","NoECE","OnTime"
"122","Yes","No",34,"Yes",49,15,80,31,127,47,15,46,90,"NoECE","Female","White",3.5042,0,"HMCSE","NoECE","OnTime"
"123","No","No",12,"No",25,13,58,33,76,18,25,58,83,"ECE","Male","White",2.6169,14,"HMCSE","ECE","OverTime"
"124","No","No",31,"Yes",45,14,80,35,106,26,27,55,87,"NoECE","Female","NoWhite",3.4954,3,"HMCSE","NoECE","OnTime"
"125","No","No",66,"No",87,21,117,30,143,26,34,64,90,"NoECE","Female","White",3.1367,7,"HMCSE","NoECE","OverTime"
"126","Yes","No",25,"Yes",47,22,77,30,90,13,35,64,78,"NoECE","Male","White",3.6967,0,"HMCSE","NoECE","OnTime"
"127","No","No",16,"Yes",33,17,44,11,67,23,33,47,65,"NoECE","Male","White",2.2969,42,"HMCSE","NoECE","OverTime"
"128","No","No",13,"Yes",19,6,49,30,78,29,22,52,81,"NoECE","Male","White",2.7198,6,"HMCSE","NoECE","OverTime"
"129","No","No",78,"No",101,23,133,32,159,26,37,69,92,"NoECE","Female","White",3.8978,0,"HMCSE","NoECE","OnTime"
"130","No","No",19,"No",35,16,66,31,107,41,29,64,105,"NoECE","Female","White",2.2171,39,"HMCSE","NoECE","OverTime"
"131","No","No",76,"No",91,15,105,14,128,23,30,44,67,"ECE","Male","NoWhite",3.3704,0,"HMCSE","ECE","OnTime"
"132","No","No",27,"No",41,14,70,29,98,28,26,54,79,"NoECE","Male","White",2.9,0,"HMCSE","NoECE","OnTime"
"133","No","No",51,"No",68,17,100,32,132,32,33,65,91,"NoECE","Male","White",2.9701,6,"HMCSE","NoECE","OnTime"
"134","No","No",18,"No",36,18,71,35,104,33,33,68,100,"NoECE","Female","White",3.347,0,"HMCSE","NoECE","OnTime"
"135","Yes","Yes",25,"Yes",50,25,81,31,106,25,38,63,91,"NoECE","Female","White",2.9886,0,"HMCSE","NoECE","OnTime"
"136","No","No",19,"Yes",32,13,62,30,93,31,26,53,80,"NoECE","Female","White",3.6892,0,"HMCSE","NoECE","OnTime"
"137","No","No",18,"No",38,20,67,29,98,31,31,60,91,"NoECE","Male","White",3.178,3,"HMCSE","NoECE","OnTime"
"138","No","No",21,"Yes",35,14,59,24,84,25,29,50,78,"ECE","Male","White",3.3707,13,"HMCSE","ECE","OverTime"
"139","Yes","No",13,"Yes",34,21,62,28,94,32,34,62,94,"NoECE","Female","NoWhite",3.2,3,"HMCSE","NoECE","OnTime"
"140","Yes","No",9,"No",33,24,57,24,85,28,34,54,88,"NoECE","Female","White",2.2435,17,"HMCSE","NoECE","OverTime"
"141","Yes","No",34,"Yes",50,16,88,38,118,30,32,70,96,"NoECE","Female","White",3.43,0,"HMCSE","NoECE","OnTime"
"142","No","No",16,"No",32,16,64,32,93,29,32,64,103,"NoECE","Female","White",2.3971,30,"HMCSE","NoECE","OverTime"
"143","Yes","Yes",15,"Yes",15,0,15,0,15,0,15,15,15,"NoECE","Male","NoWhite",2.26,3,"NoHMCSE","NoECE","OverTime"
"144","No","No",16,"No",53,37,79,26,114,35,32,61,96,"ECE","Male","White",3.1462,6,"HMCSE","ECE","OverTime"
"145","No","No",16,"No",53,37,79,26,114,35,32,61,96,"ECE","Male","White",3.1462,6,"HMCSE","ECE","OverTime"
"146","Yes","No",26,"No",38,12,65,27,89,24,26,53,77,"ECE","Male","White",3.6182,0,"HMCSE","ECE","OverTime"
"147","No","No",14,"No",28,14,63,35,98,35,28,57,98,"NoECE","Male","NoWhite",2.9583,7,"HMCSE","NoECE","OnTime"
"148","Yes","Yes",9,"Yes",21,12,44,23,72,28,24,61,86,"NoECE","Female","NoWhite",1.9988,40,"NoHMCSE","NoECE","OverTime"
"149","No","No",16,"Yes",37,21,55,18,86,31,25,52,86,"ECE","Male","White",2.8842,7,"HMCSE","ECE","OverTime"
"150","No","No",16,"Yes",37,21,55,18,86,31,25,52,86,"ECE","Male","White",2.8842,7,"HMCSE","ECE","OverTime"
"151","No","No",13,"No",29,16,51,22,81,30,29,51,77,"ECE","Female","White",3.6175,3,"HMCSE","ECE","OverTime"
"152","No","No",27,"No",42,15,71,29,109,38,31,60,92,"ECE","Male","White",3.6541,0,"HMCSE","ECE","OverTime"
"153","Yes","Yes",36,"Yes",50,14,76,26,104,28,28,54,82,"NoECE","Female","White",3.6927,0,"HMCSE","NoECE","OverTime"
"154","Yes","Yes",36,"Yes",50,14,76,26,104,28,28,54,82,"NoECE","Female","White",3.6927,0,"HMCSE","NoECE","OverTime"
"155","No","No",21,"No",31,10,72,41,99,27,23,61,88,"NoECE","Female","White",2.8365,7,"HMCSE","NoECE","OnTime"
"156","Yes","No",21,"Yes",34,13,60,26,89,29,25,51,76,"ECE","Male","NoWhite",3.2145,4,"HMCSE","ECE","OverTime"
"157","No","No",15,"Yes",46,31,71,25,81,10,34,59,73,"ECE","Male","White",3.3378,7,"HMCSE","ECE","OverTime"
"158","No","No",9,"No",25,16,57,32,87,30,25,57,87,"NoECE","Male","NoWhite",3.2851,3,"HMCSE","NoECE","OverTime"
"159","No","No",47,"No",67,20,93,26,128,35,34,60,87,"NoECE","Female","White",2.6863,11,"HMCSE","NoECE","OnTime"
"160","No","No",6,"No",40,34,80,40,107,27,37,77,104,"NoECE","Female","White",4,0,"HMCSE","NoECE","OnTime"
"161","No","No",9,"No",21,12,56,35,80,24,24,59,86,"ECE","Male","NoWhite",2.6558,9,"HMCSE","ECE","OverTime"
"162","No","No",3,"Yes",28,25,55,27,89,34,25,52,82,"NoECE","Male","White",3.3945,0,"HMCSE","NoECE","OnTime"
"163","No","No",81,"No",96,15,126,30,154,28,29,59,87,"NoECE","Male","White",3.6115,0,"HMCSE","NoECE","OnTime"
"164","No","No",56,"No",73,17,99,26,133,34,31,57,91,"NoECE","Male","White",3.9901,0,"HMCSE","NoECE","OnTime"
"165","No","No",41,"Yes",54,13,73,19,99,26,25,44,70,"NoECE","Male","NoWhite",3.6164,0,"HMCSE","NoECE","OverTime"
"166","No","No",16,"No",33,17,72,39,109,37,33,66,100,"NoECE","Female","White",3.2688,7,"HMCSE","NoECE","OnTime"
"167","No","No",16,"No",35,19,68,33,115,47,32,65,112,"NoECE","Male","NoWhite",3.4232,3,"HMCSE","NoECE","OnTime"
"168","No","No",68,"No",82,14,119,37,155,36,28,65,100,"NoECE","Female","White",3.709,0,"HMCSE","NoECE","OnTime"
"169","No","No",68,"No",82,14,119,37,155,36,28,65,100,"NoECE","Female","White",3.709,0,"HMCSE","NoECE","OnTime"
"170","No","No",64,"No",78,14,107,29,131,24,28,57,81,"NoECE","Male","White",3.6926,0,"HMCSE","NoECE","OnTime"
"171","Yes","Yes",19,"Yes",40,21,67,27,92,25,30,57,82,"NoECE","Female","NoWhite",3.0476,10,"NoHMCSE","NoECE","OverTime"
"172","No","No",16,"No",33,17,72,39,97,25,30,73,98,"NoECE","Female","White",3.125,12,"HMCSE","NoECE","OverTime"
"173","No","No",36,"Yes",49,13,94,45,129,35,13,58,91,"NoECE","Male","White",3.7737,0,"HMCSE","NoECE","OnTime"
"174","No","No",71,"No",81,10,105,24,128,23,25,49,72,"NoECE","Male","White",2.4903,19,"HMCSE","NoECE","OnTime"
"175","No","No",47,"No",61,14,72,11,92,20,30,41,57,"NoECE","Male","NoWhite",2.0475,14,"HMCSE","NoECE","OverTime"
"176","No","No",43,"No",65,22,97,32,125,28,35,64,95,"NoECE","Female","NoWhite",3.4806,0,"HMCSE","NoECE","OnTime"
"177","No","No",85,"No",97,12,106,9,133,27,27,36,57,"NoECE","Male","White",2.94,3,"HMCSE","NoECE","OnTime"
"178","Yes","No",34,"Yes",49,15,88,39,117,29,29,68,94,"NoECE","Male","White",3.8433,0,"HMCSE","NoECE","OnTime"
"179","No","No",12,"No",31,19,48,17,66,18,25,45,70,"ECE","Male","White",2.5194,11,"HMCSE","ECE","OverTime"
"180","Yes","No",12,"Yes",25,13,87,62,118,31,25,50,81,"NoECE","Female","NoWhite",2.9718,1,"HMCSE","NoECE","OnTime"
"181","No","No",13,"Yes",25,12,55,30,79,24,25,46,79,"NoECE","Male","NoWhite",3.5976,3,"HMCSE","NoECE","OverTime"
"182","No","No",27,"No",42,15,67,25,106,39,31,56,88,"ECE","Male","White",3.7358,0,"HMCSE","ECE","OverTime"
"183","No","No",14,"No",35,21,62,27,83,21,35,62,89,"NoECE","Male","NoWhite",3.1494,24,"HMCSE","NoECE","OverTime"
"184","No","No",43,"No",64,21,94,30,119,25,37,64,89,"NoECE","Male","White",3.0899,6,"HMCSE","NoECE","OnTime"
"185","Yes","Yes",13,"Yes",26,13,60,34,98,38,26,52,90,"NoECE","Female","NoWhite",3.0722,3,"HMCSE","NoECE","OverTime"
"186","Yes","No",23,"Yes",37,14,61,24,89,28,28,59,83,"NoECE","Female","White",3.41,10,"HMCSE","NoECE","OverTime"
"187","Yes","No",89,"Yes",123,34,123,0,153,30,41,51,74,"NoECE","Male","White",2.0272,38,"HMCSE","NoECE","OnTime"
"188","No","No",20,"No",42,22,72,30,97,25,35,65,91,"NoECE","Male","NoWhite",3.9266,1,"HMCSE","NoECE","OnTime"
"189","Yes","No",44,"Yes",57,13,86,29,110,24,27,53,80,"NoECE","Male","White",3.5709,1,"HMCSE","NoECE","OnTime"
"190","Yes","No",13,"Yes",31,18,60,29,101,41,31,60,101,"NoECE","Female","White",3.298,0,"HMCSE","NoECE","OnTime"
"191","Yes","Yes",13,"Yes",25,12,60,35,60,0,25,53,53,"NoECE","Female","NoWhite",3.1547,11,"NoHMCSE","NoECE","OverTime"
"192","No","No",12,"No",24,12,50,26,65,15,24,50,79,"ECE","Male","NoWhite",2.8875,4,"HMCSE","ECE","OverTime"
"193","No","No",73,"No",100,27,125,25,125,0,78,103,103,"NoECE","Male","White",3.5476,3,"HMCSE","NoECE","OnTime"
"194","Yes","Yes",91,"Yes",102,11,127,25,159,32,25,50,73,"ECE","Male","White",3.7537,0,"HMCSE","ECE","OnTime"
"195","Yes","Yes",33,"Yes",33,0,33,0,39,6,13,13,26,"ECE","Male","White",0,21,"HMCSE","NoECE","OverTime"
"196","No","No",36,"No",50,14,90,40,131,41,26,66,107,"ECE","Male","White",3.1991,4,"HMCSE","ECE","OnTime"
"197","No","No",22,"Yes",25,3,52,27,79,27,20,39,66,"ECE","Male","White",3.2754,8,"HMCSE","ECE","OverTime"
"198","No","No",0,"Yes",30,30,53,23,97,44,30,53,97,"NoECE","Female","NoWhite",3.134,0,"HMCSE","NoECE","OnTime"
"199","No","No",89,"No",105,16,134,29,163,29,30,60,85,"NoECE","Female","White",2.3896,7,"HMCSE","NoECE","OnTime"
"200","No","No",42,"No",54,12,96,42,132,36,26,59,92,"NoECE","Female","White",3.7946,0,"HMCSE","NoECE","OnTime"
"201","Yes","No",33,"Yes",59,26,99,40,141,42,36,76,110,"NoECE","Female","White",3.4882,10,"HMCSE","NoECE","OnTime"
"202","Yes","No",33,"Yes",59,26,99,40,141,42,36,76,110,"NoECE","Female","White",3.4882,10,"HMCSE","NoECE","OnTime"
"203","No","No",45,"Yes",64,19,90,26,124,34,25,58,92,"ECE","Female","White",3.8853,0,"HMCSE","ECE","OnTime"
"204","No","No",23,"No",39,16,77,38,104,27,33,71,101,"NoECE","Male","White",2.7149,16,"HMCSE","NoECE","OverTime"
"205","No","No",46,"No",58,12,89,31,118,29,28,59,88,"NoECE","Female","White",3.5795,0,"HMCSE","NoECE","OnTime"
"206","No","No",6,"Yes",40,34,73,33,103,30,24,57,87,"NoECE","Male","White",2.84,12,"HMCSE","NoECE","OnTime"
"207","Yes","No",44,"Yes",60,16,90,30,113,23,51,84,107,"NoECE","Female","White",3.5436,0,"HMCSE","NoECE","OnTime"
"208","Yes","Yes",7,"Yes",16,9,25,9,25,0,23,29,29,"NoECE","Female","NoWhite",0,26,"NoHMCSE","NoECE","OverTime"
"209","No","No",42,"No",67,25,93,26,118,25,37,63,88,"NoECE","Female","White",3.9,0,"HMCSE","NoECE","OnTime"
"210","Yes","No",27,"Yes",42,15,84,42,120,36,27,66,93,"ECE","Male","NoWhite",3.0467,0,"HMCSE","ECE","OverTime"
"211","No","No",13,"Yes",29,16,60,31,72,12,29,56,75,"NoECE","Male","White",2.7978,13,"HMCSE","NoECE","OverTime"
"212","Yes","No",34,"Yes",68,34,120,52,160,40,47,99,138,"NoECE","Male","NoWhite",3.9565,0,"HMCSE","NoECE","OnTime"
"213","Yes","No",34,"Yes",68,34,120,52,160,40,47,99,138,"NoECE","Male","NoWhite",3.9565,0,"HMCSE","NoECE","OnTime"
"214","No","No",28,"Yes",54,26,81,27,109,28,26,53,81,"NoECE","Male","White",3.2202,0,"HMCSE","NoECE","OnTime"
"215","No","No",19,"No",31,12,62,31,86,24,25,53,84,"NoECE","Female","White",3.8,0,"HMCSE","NoECE","OnTime"
"216","No","No",23,"Yes",36,13,47,11,75,28,31,42,70,"NoECE","Male","NoWhite",2.9474,9,"HMCSE","NoECE","OverTime"
"217","No","No",22,"No",35,13,66,31,95,29,29,60,89,"NoECE","Male","White",3.2169,7,"HMCSE","NoECE","OnTime"
"218","Yes","No",21,"Yes",35,14,60,25,95,35,25,54,89,"NoECE","Female","White",3.2849,4,"HMCSE","NoECE","OnTime"
"219","Yes","No",12,"Yes",30,18,56,26,86,30,30,59,93,"NoECE","Female","White",2.9538,7,"HMCSE","NoECE","OverTime"
"220","No","No",26,"No",43,17,74,31,105,31,31,62,93,"NoECE","Female","White",3.4914,3,"HMCSE","NoECE","OnTime"
"221","Yes","No",31,"Yes",51,20,77,26,114,37,27,57,93,"ECE","Female","NoWhite",3.5438,3,"HMCSE","ECE","OnTime"
"222","Yes","No",38,"Yes",62,24,94,32,120,26,40,72,97,"NoECE","Male","White",3.6907,0,"HMCSE","NoECE","OnTime"
"223","No","No",37,"No",52,15,77,25,101,24,31,56,80,"NoECE","Female","White",3.7525,0,"HMCSE","NoECE","OnTime"
"224","Yes","No",61,"Yes",75,14,119,44,135,16,14,58,74,"NoECE","Female","NoWhite",3.8593,0,"HMCSE","NoECE","OnTime"
"225","Yes","No",0,"Yes",28,28,45,17,92,47,28,45,92,"NoECE","Male","NoWhite",3.8421,0,"HMCSE","NoECE","OnTime"
"226","No","No",13,"No",25,12,50,25,76,26,25,50,76,"NoECE","Male","NoWhite",3.1329,3,"HMCSE","NoECE","OverTime"
"227","Yes","No",22,"Yes",36,14,66,30,96,30,30,57,87,"NoECE","Male","NoWhite",3.27,0,"HMCSE","NoECE","OnTime"
"228","No","No",30,"No",43,13,81,38,103,22,23,61,87,"NoECE","Male","White",3.188,15,"HMCSE","NoECE","OnTime"
"229","No","No",0,"Yes",30,30,52,22,100,48,30,52,100,"NoECE","Male","NoWhite",3.3849,0,"HMCSE","NoECE","OnTime"
"230","Yes","Yes",12,"Yes",27,15,54,27,81,27,27,57,84,"NoECE","Male","White",2.8143,6,"HMCSE","NoECE","OverTime"
"231","No","No",6,"Yes",21,15,49,28,90,41,15,43,84,"NoECE","Female","White",3.5758,0,"HMCSE","NoECE","OnTime"
"232","No","No",48,"No",61,13,83,22,104,21,26,55,76,"NoECE","Male","White",2.8329,10,"HMCSE","NoECE","OverTime"
"233","No","No",32,"No",49,17,73,24,86,13,30,54,71,"NoECE","Male","White",2.2099,17,"HMCSE","NoECE","OverTime"
"234","Yes","Yes",13,"Yes",25,12,60,35,63,3,25,28,31,"NoECE","Female","White",3.6032,0,"NoHMCSE","NoECE","OverTime"
"235","Yes","No",12,"No",25,13,63,38,92,29,25,63,95,"NoECE","Male","NoWhite",2.6611,5,"HMCSE","NoECE","OverTime"
"236","No","No",16,"No",31,15,56,25,97,41,34,65,106,"NoECE","Female","NoWhite",2.3811,30,"HMCSE","NoECE","OnTime"
"237","Yes","Yes",33,"Yes",46,13,78,32,85,7,26,53,60,"NoECE","Male","White",3.0517,0,"HMCSE","NoECE","OverTime"
"238","Yes","No",20,"No",40,20,66,26,90,24,34,60,93,"ECE","Male","White",2.5753,21,"HMCSE","ECE","OverTime"
"239","No","No",24,"Yes",40,16,54,14,97,43,32,46,86,"NoECE","Male","White",3.7411,0,"HMCSE","NoECE","OnTime"
"240","No","No",49,"No",62,13,94,32,126,32,25,57,89,"NoECE","Male","White",3.109,0,"HMCSE","NoECE","OnTime"
"241","No","No",76,"No",98,22,124,26,149,25,37,63,88,"NoECE","Female","NoWhite",3.8936,0,"HMCSE","NoECE","OnTime"
"242","Yes","Yes",6,"Yes",12,6,28,16,36,8,24,40,48,"NoECE","Male","White",2.0417,21,"NoHMCSE","NoECE","OverTime"
"243","No","No",16,"No",26,10,26,0,26,0,28,28,28,"ECE","Male","White",2.15,6,"HMCSE","ECE","OverTime"
"244","Yes","Yes",34,"Yes",67,33,123,56,153,30,49,99,129,"NoECE","Female","White",3.0543,7,"HMCSE","NoECE","OnTime"
"245","Yes","No",12,"Yes",40,28,67,27,95,28,28,55,83,"NoECE","Female","NoWhite",3.8378,3,"HMCSE","NoECE","OnTime"
"246","No","No",21,"No",33,12,64,31,97,33,27,58,91,"NoECE","Male","White",3.3209,0,"HMCSE","NoECE","OnTime"
"247","No","No",13,"No",29,16,70,41,100,30,29,64,94,"NoECE","Female","White",3.0968,3,"HMCSE","NoECE","OverTime"
"248","No","No",27,"No",40,13,73,33,106,33,28,56,82,"ECE","Male","White",3.3681,0,"HMCSE","ECE","OverTime"
"249","Yes","No",15,"Yes",28,13,52,24,77,25,28,52,77,"NoECE","Female","White",3.0679,16,"HMCSE","NoECE","OverTime"
"250","No","No",47,"No",72,25,106,34,131,25,39,73,97,"NoECE","Female","White",2.8959,11,"HMCSE","NoECE","OnTime"
"251","Yes","No",26,"Yes",42,16,68,26,93,25,28,54,83,"NoECE","Male","NoWhite",3.5023,0,"HMCSE","NoECE","OverTime"
"252","Yes","No",15,"Yes",28,13,58,30,89,31,25,55,86,"NoECE","Male","NoWhite",2.8093,10,"HMCSE","NoECE","OnTime"
"253","Yes","Yes",37,"Yes",47,10,73,26,82,9,25,55,67,"NoECE","Female","White",2.3418,17,"NoHMCSE","NoECE","OverTime"
"254","Yes","No",24,"Yes",47,23,70,23,92,22,37,63,81,"NoECE","Male","NoWhite",2.8012,20,"HMCSE","NoECE","OverTime"
"255","No","No",0,"Yes",29,29,62,33,96,34,27,56,93,"NoECE","Male","NoWhite",2.9894,10,"HMCSE","NoECE","OnTime"
"256","No","No",63,"Yes",91,28,123,32,141,18,84,116,134,"NoECE","Female","White",3.9619,0,"HMCSE","NoECE","OnTime"
"257","Yes","No",50,"Yes",64,14,78,14,103,25,26,40,65,"NoECE","Male","NoWhite",3.4721,0,"HMCSE","NoECE","OnTime"
"258","No","No",47,"Yes",66,19,96,30,114,18,6,39,57,"NoECE","Male","NoWhite",2.565,18,"HMCSE","NoECE","OnTime"
"259","Yes","Yes",19,"Yes",19,0,19,0,19,0,13,13,13,"NoECE","Female","White",2.6231,0,"NoHMCSE","NoECE","OverTime"
"260","No","No",14,"No",37,23,63,26,100,37,37,63,100,"NoECE","Male","White",3.499,3,"HMCSE","NoECE","OnTime"
"261","No","No",19,"No",35,16,67,32,95,28,29,61,89,"ECE","Female","White",4,0,"HMCSE","ECE","OverTime"
"262","No","No",13,"Yes",26,13,53,27,83,30,26,53,83,"NoECE","Female","NoWhite",3.5289,0,"HMCSE","NoECE","OverTime"
"263","No","No",18,"Yes",30,12,57,27,87,30,21,51,81,"NoECE","Female","NoWhite",2.756,3,"HMCSE","NoECE","OverTime"
"264","No","No",44,"No",62,18,91,29,122,31,29,58,89,"NoECE","Female","White",4,0,"HMCSE","NoECE","OnTime"
"265","No","No",26,"Yes",48,22,70,22,97,27,35,61,88,"NoECE","Male","NoWhite",3.8912,0,"HMCSE","NoECE","OverTime"
"266","Yes","No",26,"Yes",49,23,93,44,129,36,37,81,117,"NoECE","Male","NoWhite",3.6333,0,"HMCSE","NoECE","OnTime"
"267","No","No",9,"No",28,19,53,25,74,21,28,57,78,"NoECE","Male","White",2.8333,19,"HMCSE","NoECE","OverTime"
"268","No","No",16,"Yes",29,13,56,27,79,23,29,57,84,"ECE","Male","NoWhite",2.4697,24,"HMCSE","ECE","OverTime"
"269","Yes","No",19,"Yes",40,21,68,28,95,27,30,55,85,"NoECE","Male","White",3.0307,9,"HMCSE","NoECE","OnTime"
"270","No","No",33,"No",45,12,83,38,112,29,24,61,90,"NoECE","Male","White",2.7289,10,"HMCSE","NoECE","OnTime"
"271","Yes","No",14,"No",46,32,73,27,98,25,23,50,69,"NoECE","Male","White",3.1787,0,"HMCSE","NoECE","OverTime"
"272","No","No",15,"No",30,15,58,28,86,28,27,59,83,"NoECE","Male","White",3.0434,8,"HMCSE","NoECE","OnTime"
"273","Yes","No",47,"Yes",68,21,95,27,128,33,37,63,93,"NoECE","Male","White",3.1104,4,"HMCSE","NoECE","OnTime"
"274","Yes","No",13,"Yes",32,19,62,30,86,24,32,62,86,"NoECE","Female","NoWhite",3.4988,0,"HMCSE","NoECE","OverTime"
"275","No","No",43,"Yes",62,19,81,19,112,31,28,51,82,"NoECE","Male","White",3.2729,10,"HMCSE","NoECE","OnTime"
"276","No","No",6,"No",38,32,63,25,96,33,38,63,96,"NoECE","Female","NoWhite",2.7882,10,"HMCSE","NoECE","OverTime"
"277","No","No",68,"No",83,15,107,24,132,25,28,52,77,"NoECE","Female","White",3.5377,0,"HMCSE","NoECE","OnTime"
"278","No","No",27,"No",40,13,73,33,98,25,27,60,85,"ECE","Male","NoWhite",2.8024,6,"HMCSE","ECE","OverTime"
"279","No","No",15,"Yes",45,30,72,27,107,35,25,46,73,"NoECE","Male","White",3.9761,0,"HMCSE","NoECE","OnTime"
"280","No","No",0,"Yes",15,15,59,44,95,36,15,59,95,"NoECE","Female","White",3.6265,0,"HMCSE","NoECE","OnTime"
"281","No","No",13,"No",28,15,59,31,92,33,28,59,83,"NoECE","Female","White",3.4641,0,"HMCSE","NoECE","OverTime"
"282","Yes","Yes",9,"Yes",28,19,60,32,88,28,32,60,76,"NoECE","Female","White",3.3197,8,"NoHMCSE","NoECE","OnTime"
"283","No","No",30,"Yes",42,12,71,29,79,8,24,52,61,"NoECE","Female","NoWhite",3.5609,12,"HMCSE","NoECE","OverTime"
"284","No","No",43,"No",57,14,90,33,116,26,28,61,87,"NoECE","Female","White",3.5713,0,"HMCSE","NoECE","OnTime"
"285","No","No",3,"Yes",16,13,44,28,87,43,13,38,81,"NoECE","Male","White",3.3813,3,"HMCSE","NoECE","OnTime"
"286","Yes","No",16,"Yes",40,24,68,28,99,31,40,68,99,"NoECE","Female","White",3.3202,3,"HMCSE","NoECE","OnTime"
"287","No","No",34,"No",51,17,85,34,122,37,30,64,101,"NoECE","Female","White",3.2604,1,"HMCSE","NoECE","OnTime"
"288","Yes","Yes",36,"Yes",42,6,42,0,42,0,22,22,22,"NoECE","Female","White",2.7318,11,"NoHMCSE","NoECE","OverTime"
"289","Yes","No",27,"Yes",42,15,70,28,102,32,30,62,94,"NoECE","Female","White",3.15,0,"HMCSE","NoECE","OnTime"
"290","No","No",12,"No",24,12,52,28,71,19,24,49,68,"NoECE","Male","White",3.2779,21,"HMCSE","NoECE","OverTime"
"291","No","No",42,"No",62,20,86,24,126,40,27,58,95,"NoECE","Female","White",2.8297,26,"HMCSE","NoECE","OnTime"
"292","Yes","No",30,"Yes",75,45,109,34,140,31,26,60,89,"NoECE","Female","White",3.9899,0,"HMCSE","NoECE","OnTime"
"293","No","No",50,"No",65,15,89,24,117,28,31,58,83,"NoECE","Female","White",2.8013,29,"HMCSE","NoECE","OnTime"
"294","No","No",92,"No",108,16,136,28,148,12,31,56,75,"NoECE","Male","NoWhite",3.0132,4,"HMCSE","NoECE","OnTime"
"295","Yes","No",13,"Yes",30,17,59,29,73,14,30,56,72,"ECE","Male","White",3.9321,0,"HMCSE","NoECE","OverTime"
"296","No","No",13,"Yes",25,12,50,25,74,24,25,50,73,"ECE","Male","NoWhite",2.6579,12,"HMCSE","ECE","OverTime"
"297","Yes","No",10,"Yes",28,18,56,28,68,12,28,59,68,"NoECE","Female","NoWhite",2.0603,52,"HMCSE","NoECE","OverTime"
"298","No","No",35,"Yes",51,16,73,22,88,15,30,55,70,"NoECE","Male","White",3.2756,0,"HMCSE","NoECE","OverTime"
"299","No","No",21,"No",31,10,56,25,82,26,24,49,75,"ECE","Male","White",2.9773,12,"HMCSE","ECE","OverTime"
"300","No","No",48,"No",65,17,97,32,135,38,33,65,94,"NoECE","Female","White",3.7,0,"HMCSE","NoECE","OnTime"
"301","Yes","No",34,"Yes",54,20,68,14,102,34,29,46,80,"NoECE","Female","White",3.7701,0,"HMCSE","NoECE","OverTime"
"302","No","No",24,"No",37,13,66,29,99,33,25,6,39,"NoECE","Male","White",2.4538,24,"HMCSE","NoECE","OverTime"
"303","Yes","No",11,"Yes",28,17,65,37,86,21,42,79,113,"NoECE","Female","White",2.1189,44,"HMCSE","NoECE","OverTime"
"304","No","No",23,"Yes",40,17,73,33,100,27,30,60,87,"ECE","Male","White",3.8833,0,"HMCSE","ECE","OverTime"
"305","No","No",23,"Yes",40,17,73,33,100,27,30,60,87,"ECE","Male","White",3.8833,0,"HMCSE","ECE","OverTime"
"306","Yes","No",12,"Yes",30,18,60,30,74,14,30,60,74,"NoECE","Male","White",2.6471,19,"HMCSE","NoECE","OverTime"
"307","Yes","No",52,"No",66,14,97,31,127,30,27,58,88,"ECE","Male","White",3.4807,0,"HMCSE","ECE","OnTime"
"308","No","No",71,"No",95,24,131,36,161,30,38,74,104,"NoECE","Female","NoWhite",3.7721,0,"HMCSE","NoECE","OnTime"
"309","No","No",12,"Yes",39,27,68,29,104,36,27,54,90,"NoECE","Female","White",3.6667,4,"HMCSE","NoECE","OnTime"
"310","Yes","No",17,"Yes",36,19,62,26,97,35,33,59,94,"NoECE","Female","White",2.7628,6,"HMCSE","NoECE","OnTime"
"311","No","No",77,"Yes",103,26,134,31,158,24,26,57,81,"NoECE","Female","NoWhite",3.5191,0,"HMCSE","NoECE","OnTime"
"312","No","No",43,"No",61,18,94,33,126,32,32,62,94,"NoECE","Female","White",3.7093,0,"HMCSE","NoECE","OnTime"
"313","Yes","No",22,"Yes",38,16,56,18,85,29,25,50,79,"NoECE","Male","White",2.9227,6,"HMCSE","NoECE","OnTime"
"314","No","No",52,"Yes",67,15,79,12,79,0,32,54,54,"ECE","Male","NoWhite",0,23,"HMCSE","ECE","OverTime"
"315","Yes","No",0,"Yes",12,12,51,39,87,36,12,51,87,"NoECE","Male","White",3.2553,6,"HMCSE","NoECE","OnTime"
"316","Yes","No",32,"Yes",44,12,74,30,83,9,25,49,64,"NoECE","Male","White",2.2521,28,"HMCSE","NoECE","OverTime"
"317","Yes","Yes",57,"Yes",71,14,100,29,125,25,28,59,77,"NoECE","Male","White",3.3802,6,"HMCSE","NoECE","OverTime"
"318","No","No",6,"Yes",33,27,61,28,82,21,27,55,76,"NoECE","Female","White",3.5178,4,"HMCSE","NoECE","OnTime"
"319","Yes","Yes",0,"Yes",0,0,0,0,0,0,12,12,12,"NoECE","Male","White",0,21,"NoHMCSE","NoECE","OverTime"
"320","No","No",12,"Yes",25,13,57,32,85,28,25,51,79,"NoECE","Male","NoWhite",2.6683,19,"HMCSE","NoECE","OverTime"
"321","Yes","No",43,"Yes",58,15,89,31,107,18,28,59,79,"NoECE","Male","White",3.3468,16,"HMCSE","NoECE","OverTime"
"322","Yes","Yes",73,"Yes",85,12,109,24,136,27,26,50,74,"NoECE","Female","White",2.9792,6,"HMCSE","NoECE","OnTime"
"323","Yes","Yes",73,"Yes",85,12,109,24,136,27,26,50,74,"NoECE","Female","White",2.9792,6,"NoHMCSE","NoECE","OnTime"
"324","No","No",22,"No",35,13,65,30,96,31,26,56,87,"NoECE","Male","White",3.923,0,"HMCSE","NoECE","OnTime"
"325","Yes","No",23,"Yes",43,20,81,38,114,33,33,71,104,"NoECE","Female","White",3.2452,6,"HMCSE","NoECE","OverTime"
"326","Yes","No",13,"Yes",26,13,56,30,85,29,26,56,85,"NoECE","Female","NoWhite",3.7447,0,"HMCSE","NoECE","OverTime"
"327","No","No",16,"No",39,23,72,33,113,41,27,60,100,"NoECE","Male","White",3.259,0,"HMCSE","NoECE","OnTime"
"328","No","No",53,"No",70,17,94,24,117,23,30,54,77,"NoECE","Female","White",3.7792,7,"HMCSE","NoECE","OverTime"
"329","No","No",14,"No",35,21,76,41,115,39,35,76,114,"NoECE","Male","White",3.5921,1,"HMCSE","NoECE","OnTime"
"330","No","No",16,"Yes",28,12,73,45,114,41,12,57,97,"NoECE","Male","White",3.7274,3,"HMCSE","NoECE","OnTime"
"331","Yes","No",35,"No",50,15,77,27,83,6,27,54,60,"NoECE","Male","White",3.0895,21,"HMCSE","NoECE","OverTime"
"332","No","No",56,"No",76,20,104,28,129,25,32,60,96,"NoECE","Female","White",2.6573,30,"HMCSE","NoECE","OverTime"
"333","No","No",36,"No",65,29,106,41,133,27,44,85,112,"NoECE","Female","White",3.8911,0,"HMCSE","NoECE","OnTime"
"334","No","No",42,"No",66,24,96,30,134,38,38,68,96,"NoECE","Male","NoWhite",3.8406,0,"HMCSE","NoECE","OnTime"
"335","Yes","No",19,"Yes",33,14,61,28,100,39,27,58,98,"NoECE","Male","White",2.9766,7,"HMCSE","NoECE","OverTime"
"336","No","No",47,"No",60,13,96,36,131,35,27,63,98,"NoECE","Female","NoWhite",3.7673,0,"HMCSE","NoECE","OnTime"
"337","Yes","No",22,"Yes",38,16,79,41,109,30,32,73,100,"NoECE","Female","White",3.0184,0,"HMCSE","NoECE","OnTime"
"338","No","No",22,"No",36,14,74,38,101,27,27,65,92,"NoECE","Male","White",3.8859,0,"HMCSE","NoECE","OnTime"
"339","No","No",13,"Yes",42,29,79,37,105,26,29,57,83,"NoECE","Female","NoWhite",3.0012,3,"HMCSE","NoECE","OnTime"
"340","No","No",54,"No",68,14,98,30,124,26,27,51,82,"NoECE","Female","White",3.6576,0,"HMCSE","NoECE","OnTime"
"341","No","No",31,"No",41,10,76,35,106,30,27,62,95,"NoECE","Female","White",2.3411,30,"HMCSE","NoECE","OverTime"
"342","Yes","No",84,"No",100,16,130,30,131,1,31,61,61,"ECE","Male","White",3.6922,0,"HMCSE","ECE","OnTime"
"343","No","No",18,"No",33,15,75,42,105,30,27,63,97,"NoECE","Female","White",3.1423,0,"HMCSE","NoECE","OverTime"
"344","Yes","No",18,"Yes",36,18,67,31,82,15,31,66,80,"ECE","Female","White",2.1438,21,"HMCSE","ECE","OverTime"
"345","No","No",43,"Yes",58,15,83,25,101,18,28,56,74,"NoECE","Female","NoWhite",3.5483,6,"HMCSE","NoECE","OverTime"
"346","Yes","No",37,"No",53,16,84,31,113,29,32,60,89,"NoECE","Female","White",3.7978,0,"HMCSE","NoECE","OnTime"
"347","Yes","No",0,"Yes",28,28,64,36,81,17,28,60,77,"NoECE","Female","NoWhite",3.9033,0,"HMCSE","NoECE","OnTime"
"348","Yes","No",60,"Yes",78,18,112,34,141,29,34,68,100,"NoECE","Male","White",3.564,6,"HMCSE","NoECE","OnTime"
"349","Yes","No",12,"Yes",22,10,42,20,72,30,22,45,72,"NoECE","Male","White",2.7014,10,"HMCSE","NoECE","OverTime"
"350","No","No",24,"No",42,18,81,39,98,17,32,64,87,"NoECE","Female","White",3.9602,3,"HMCSE","NoECE","OnTime"
"351","Yes","No",23,"Yes",42,19,66,24,95,29,26,56,85,"NoECE","Female","White",3.4145,9,"HMCSE","NoECE","OverTime"
"352","No","No",54,"Yes",67,13,91,24,129,38,28,51,86,"NoECE","Male","White",3.5629,0,"HMCSE","NoECE","OnTime"
"353","No","No",35,"No",49,14,86,37,115,29,28,65,93,"NoECE","Male","White",3.4828,0,"HMCSE","NoECE","OnTime"
"354","Yes","No",13,"Yes",25,12,55,30,85,30,25,55,85,"NoECE","Female","White",2.9976,3,"HMCSE","NoECE","OverTime"
"355","Yes","No",13,"No",25,12,52,27,76,24,25,52,76,"NoECE","Male","White",2.8842,7,"HMCSE","NoECE","OverTime"
"356","Yes","Yes",43,"Yes",57,14,86,29,117,31,28,57,88,"NoECE","Female","White",3.8477,0,"NoHMCSE","NoECE","OnTime"
"357","Yes","Yes",43,"Yes",57,14,86,29,117,31,28,57,88,"NoECE","Female","White",3.8477,0,"HMCSE","NoECE","OnTime"
"358","Yes","No",13,"Yes",29,16,62,33,94,32,29,59,91,"NoECE","Male","White",3.0341,5,"HMCSE","NoECE","OverTime"
"359","Yes","No",73,"Yes",89,16,121,32,139,18,28,60,77,"NoECE","Male","NoWhite",3.9519,0,"HMCSE","NoECE","OnTime"
"360","No","No",29,"No",52,23,78,26,119,41,39,65,106,"ECE","Male","White",3.8302,0,"HMCSE","ECE","OverTime"
"361","Yes","Yes",29,"Yes",50,21,76,26,103,27,34,60,87,"ECE","Male","NoWhite",3.1253,6,"HMCSE","ECE","OverTime"
"362","Yes","No",14,"Yes",27,13,45,18,71,26,27,45,71,"NoECE","Female","White",3.3835,7,"HMCSE","NoECE","OverTime"
"363","Yes","No",37,"Yes",51,14,78,27,107,29,31,58,87,"NoECE","Male","White",3.5879,0,"HMCSE","NoECE","OnTime"
"364","Yes","No",14,"Yes",26,12,51,25,102,51,26,51,83,"NoECE","Female","NoWhite",3.3446,0,"HMCSE","NoECE","OverTime"
"365","No","No",29,"Yes",43,14,66,23,90,24,35,61,94,"ECE","Male","NoWhite",2.446,23,"HMCSE","ECE","OverTime"
"366","No","No",14,"No",31,17,43,12,52,9,28,40,46,"NoECE","Female","White",3.0522,53,"HMCSE","NoECE","OverTime"
"367","No","No",25,"No",38,13,58,20,90,32,26,46,71,"ECE","Male","NoWhite",3.2299,1,"HMCSE","ECE","OverTime"
"368","Yes","No",22,"Yes",46,24,70,24,98,28,29,65,96,"NoECE","Male","White",2.848,10,"HMCSE","NoECE","OverTime"
"369","Yes","No",13,"Yes",27,14,64,37,85,21,27,64,88,"NoECE","Female","White",3.5489,3,"HMCSE","NoECE","OverTime"
"370","No","No",16,"No",29,13,52,23,82,30,26,52,82,"NoECE","Male","NoWhite",2.5512,14,"HMCSE","NoECE","OverTime"
"371","No","No",23,"No",39,16,69,30,92,23,17,47,70,"NoECE","Male","NoWhite",3.2529,10,"HMCSE","NoECE","OnTime"
"372","No","No",46,"No",58,12,98,40,125,27,29,69,94,"NoECE","Female","White",3.5936,0,"HMCSE","NoECE","OnTime"
"373","No","No",28,"No",46,18,84,38,121,37,31,69,106,"NoECE","Male","White",3.9736,0,"HMCSE","NoECE","OnTime"
"374","No","No",17,"No",32,15,65,33,99,34,27,57,82,"ECE","Male","White",3.4033,3,"HMCSE","ECE","OverTime"
"375","No","No",17,"No",32,15,65,33,99,34,27,57,82,"ECE","Male","White",3.4033,3,"HMCSE","ECE","OverTime"
"376","No","No",14,"Yes",27,13,53,26,64,11,27,53,64,"NoECE","Female","NoWhite",2.3885,7,"HMCSE","NoECE","OnTime"
"377","Yes","Yes",12,"Yes",60,48,90,30,118,28,30,56,88,"NoECE","Male","NoWhite",3.8041,0,"HMCSE","NoECE","OnTime"
"378","Yes","No",50,"Yes",66,16,97,31,129,32,30,61,93,"NoECE","Male","White",3.1484,1,"HMCSE","NoECE","OnTime"
"379","No","No",71,"No",82,11,109,27,131,22,21,48,66,"NoECE","Female","White",2.5507,19,"HMCSE","NoECE","OnTime"
"380","No","No",15,"No",33,18,60,27,88,28,33,60,85,"NoECE","Male","White",2.5459,11,"HMCSE","NoECE","OverTime"
"381","No","No",59,"No",81,22,110,29,138,28,37,66,94,"NoECE","Female","NoWhite",3.8617,4,"HMCSE","NoECE","OnTime"
"382","No","No",12,"No",27,15,46,19,79,33,27,46,73,"NoECE","Male","White",2.9014,9,"HMCSE","NoECE","OverTime"
"383","No","No",27,"No",47,20,85,38,112,27,34,72,99,"NoECE","Male","White",3.3899,1,"HMCSE","NoECE","OnTime"
"384","No","No",36,"No",50,14,82,32,111,29,30,62,91,"NoECE","Male","White",3.7297,0,"HMCSE","NoECE","OnTime"
"385","No","No",32,"Yes",44,12,69,25,87,18,26,51,69,"ECE","Male","NoWhite",2.525,17,"HMCSE","ECE","OverTime"
"386","No","No",26,"Yes",45,19,74,29,98,24,33,60,86,"NoECE","Female","NoWhite",3.3719,0,"HMCSE","NoECE","OnTime"
"387","No","No",13,"Yes",27,14,41,14,83,42,27,41,83,"NoECE","Female","NoWhite",3.3659,4,"HMCSE","NoECE","OverTime"
"388","Yes","No",46,"Yes",68,22,97,29,128,31,38,67,98,"NoECE","Male","White",3.6347,0,"HMCSE","NoECE","OnTime"
"389","Yes","No",40,"Yes",55,15,91,36,120,29,36,64,98,"ECE","Male","White",3.3182,1,"HMCSE","ECE","OnTime"
"390","No","No",13,"No",26,13,53,27,83,30,26,53,83,"NoECE","Male","NoWhite",3.1886,4,"HMCSE","NoECE","OverTime"
"391","Yes","Yes",10,"Yes",29,19,55,26,70,15,25,48,64,"NoECE","Female","White",2.9016,20,"NoHMCSE","NoECE","OverTime"
"392","No","No",61,"No",82,21,126,44,144,18,38,70,100,"ECE","Male","NoWhite",3.5198,0,"HMCSE","ECE","OnTime"
"393","Yes","Yes",9,"Yes",37,28,62,25,93,31,35,59,94,"NoECE","Female","White",2.3734,27,"NoHMCSE","NoECE","OverTime"
"394","No","No",16,"No",31,15,63,32,97,34,31,59,92,"ECE","Male","White",2.8685,0,"HMCSE","ECE","OverTime"
"395","No","No",16,"No",31,15,63,32,97,34,31,59,92,"ECE","Male","White",2.8685,0,"HMCSE","ECE","OverTime"
"396","Yes","No",60,"Yes",76,16,107,31,139,32,30,61,93,"NoECE","Female","White",3.8935,0,"HMCSE","NoECE","OverTime"
"397","No","No",21,"Yes",39,18,63,24,84,21,26,46,72,"NoECE","Male","White",2.226,28,"HMCSE","NoECE","OverTime"
"398","No","No",13,"No",33,20,69,36,103,34,33,69,103,"NoECE","Male","White",3.8961,0,"HMCSE","NoECE","OnTime"
"399","No","No",16,"No",29,13,52,23,83,31,29,55,83,"NoECE","Male","White",2.5325,13,"HMCSE","NoECE","OverTime"
"400","No","No",14,"Yes",32,18,59,27,89,30,28,59,89,"ECE","Male","White",3.9242,0,"HMCSE","ECE","OverTime"
"401","No","No",31,"No",43,12,99,56,105,6,24,50,59,"NoECE","Male","NoWhite",3.6739,7,"HMCSE","NoECE","OnTime"
"402","Yes","No",19,"Yes",35,16,55,20,72,17,26,53,73,"NoECE","Female","White",3.178,7,"HMCSE","NoECE","OverTime"
"403","No","No",16,"Yes",29,13,42,13,67,25,29,42,67,"NoECE","Male","NoWhite",3.1282,11,"HMCSE","NoECE","OverTime"
"404","No","No",9,"No",30,21,62,32,95,33,24,56,89,"NoECE","Female","White",3.3169,16,"HMCSE","NoECE","OverTime"
"405","No","No",68,"No",103,35,120,17,133,13,31,60,73,"NoECE","Female","White",2.9129,10,"HMCSE","NoECE","OnTime"
"406","No","No",6,"No",21,15,49,28,77,28,25,52,77,"NoECE","Female","White",2.3025,25,"HMCSE","NoECE","OverTime"
"407","No","No",10,"Yes",37,27,71,34,105,34,30,64,98,"NoECE","Female","NoWhite",3.3058,0,"HMCSE","NoECE","OnTime"
"408","No","No",30,"No",46,16,46,0,46,0,31,31,31,"NoECE","Male","White",2.1935,3,"HMCSE","NoECE","OverTime"
"409","No","No",35,"No",48,13,79,31,104,25,29,59,86,"ECE","Female","NoWhite",2.8081,9,"HMCSE","ECE","OverTime"
"410","No","No",27,"No",44,17,72,28,105,33,30,58,91,"NoECE","Female","White",3.333,0,"HMCSE","NoECE","OnTime"
"411","No","No",31,"No",44,13,70,26,105,35,26,52,90,"NoECE","Male","NoWhite",3.1138,8,"HMCSE","NoECE","OnTime"
"412","Yes","No",31,"Yes",51,20,71,20,81,10,34,61,78,"ECE","Male","NoWhite",2.6436,43,"HMCSE","NoECE","OverTime"
"413","Yes","Yes",41,"Yes",58,17,82,24,105,23,27,51,65,"NoECE","Male","White",3.0176,31,"NoHMCSE","NoECE","OverTime"
"414","No","No",44,"Yes",71,27,102,31,107,5,27,58,63,"NoECE","Male","White",3.6667,0,"HMCSE","NoECE","OnTime"
"415","Yes","No",13,"Yes",35,22,63,28,94,31,35,63,91,"NoECE","Female","White",3.4286,0,"HMCSE","NoECE","OverTime"
"416","No","No",61,"Yes",73,12,107,34,119,12,12,46,58,"NoECE","Female","White",2.7806,6,"HMCSE","NoECE","OnTime"
"417","No","No",22,"No",35,13,63,28,89,26,25,53,79,"NoECE","Male","White",3.7481,0,"HMCSE","NoECE","OverTime"
"418","No","No",35,"Yes",51,16,77,26,106,29,27,56,85,"NoECE","Female","White",3.1539,0,"HMCSE","NoECE","OnTime"
"419","No","No",41,"No",61,20,90,29,119,29,34,60,91,"ECE","Male","White",3.916,0,"HMCSE","ECE","OnTime"
"420","No","No",15,"Yes",45,30,77,32,96,19,30,62,81,"NoECE","Male","White",3.4128,0,"HMCSE","NoECE","OnTime"
"421","No","No",29,"No",40,11,77,37,102,25,28,54,86,"NoECE","Female","White",3.9427,0,"HMCSE","NoECE","OnTime"
"422","No","No",13,"No",37,24,66,29,97,31,37,66,96,"NoECE","Female","NoWhite",3.0802,0,"HMCSE","NoECE","OverTime"
"423","Yes","No",24,"No",39,15,67,28,94,27,27,55,79,"NoECE","Male","White",3.0228,6,"HMCSE","NoECE","OverTime"
"424","No","No",13,"Yes",26,13,48,22,67,19,26,51,64,"NoECE","Female","NoWhite",2.7214,12,"HMCSE","NoECE","OverTime"
"425","No","No",26,"No",38,12,67,29,108,41,25,50,87,"NoECE","Female","White",3.1529,4,"HMCSE","NoECE","OnTime"
"426","No","No",35,"No",54,19,89,35,113,24,32,67,91,"NoECE","Male","NoWhite",3.1473,4,"HMCSE","NoECE","OnTime"
"427","No","No",18,"No",35,17,67,32,96,29,29,61,89,"NoECE","Male","White",3.7189,0,"HMCSE","NoECE","OnTime"
"428","Yes","Yes",47,"Yes",59,12,85,26,96,11,26,52,66,"NoECE","Male","White",2.7923,8,"NoHMCSE","NoECE","OverTime"
"429","No","No",6,"Yes",12,6,12,0,12,0,24,24,24,"NoECE","Male","White",0,15,"HMCSE","NoECE","OverTime"
"430","Yes","Yes",27,"Yes",44,17,44,0,44,0,30,30,30,"NoECE","Female","White",2.2455,12,"NoHMCSE","NoECE","OverTime"
"431","Yes","Yes",13,"Yes",28,15,60,32,60,0,28,60,60,"NoECE","Female","White",3.4633,0,"NoHMCSE","NoECE","OverTime"
"432","Yes","No",13,"Yes",19,6,37,18,51,14,19,37,47,"NoECE","Male","NoWhite",2.9392,17,"HMCSE","NoECE","OverTime"
"433","No","No",9,"No",21,12,52,31,80,28,21,55,80,"ECE","Male","NoWhite",3.1488,13,"HMCSE","ECE","OverTime"
"434","Yes","Yes",12,"Yes",28,16,58,30,95,37,28,58,92,"NoECE","Female","White",3.7576,0,"HMCSE","NoECE","OverTime"
"435","Yes","Yes",22,"Yes",42,20,77,35,104,27,36,71,98,"NoECE","Male","NoWhite",3.1827,4,"NoHMCSE","NoECE","OverTime"
"436","Yes","Yes",22,"Yes",42,20,77,35,104,27,36,71,98,"NoECE","Male","NoWhite",3.1827,4,"HMCSE","NoECE","OverTime"
"437","No","No",20,"Yes",41,21,72,31,84,12,35,62,78,"NoECE","Male","NoWhite",3.175,0,"HMCSE","NoECE","OverTime"
"438","Yes","No",15,"Yes",36,21,48,12,70,22,36,73,107,"NoECE","Male","NoWhite",1.7365,50,"HMCSE","NoECE","OverTime"
"439","No","No",74,"No",88,14,114,26,145,31,24,50,74,"NoECE","Female","White",2.8901,13,"HMCSE","NoECE","OnTime"
"440","Yes","No",21,"No",39,18,77,38,110,33,27,65,98,"NoECE","Male","White",2.801,9,"HMCSE","NoECE","OnTime"
"441","No","No",16,"No",38,22,59,21,77,18,38,63,75,"NoECE","Male","NoWhite",2.6716,18,"HMCSE","NoECE","OverTime"
"442","Yes","Yes",34,"Yes",49,15,90,41,129,39,28,53,88,"NoECE","Female","NoWhite",3.8625,0,"HMCSE","NoECE","OnTime"
"443","No","No",17,"No",32,15,51,19,72,21,28,54,77,"ECE","Male","NoWhite",2.6364,19,"HMCSE","ECE","OverTime"
"444","Yes","Yes",13,"Yes",30,17,60,30,93,33,30,60,97,"NoECE","Female","NoWhite",3.2237,11,"HMCSE","NoECE","OverTime"
"445","No","No",18,"Yes",43,25,58,15,99,41,30,55,94,"NoECE","Male","NoWhite",3.5918,3,"HMCSE","NoECE","OnTime"
"446","No","No",12,"No",37,25,76,39,101,25,37,76,101,"NoECE","Male","NoWhite",2.8584,6,"HMCSE","NoECE","OnTime"
"447","No","No",21,"Yes",32,11,54,22,87,33,29,52,85,"NoECE","Female","NoWhite",2.9957,7,"HMCSE","NoECE","OnTime"
"448","Yes","No",21,"No",37,16,70,33,104,34,28,61,95,"NoECE","Male","White",3.6579,3,"HMCSE","NoECE","OnTime"
"449","No","No",58,"No",77,19,105,28,132,27,33,61,87,"NoECE","Female","NoWhite",4,0,"HMCSE","NoECE","OnTime"
"450","No","No",16,"No",32,16,58,26,86,28,26,52,78,"NoECE","Female","NoWhite",3.0536,10,"HMCSE","NoECE","OverTime"
"451","No","No",13,"No",29,16,62,33,95,33,29,62,95,"NoECE","Male","White",3.1642,6,"HMCSE","NoECE","OnTime"
"452","Yes","Yes",9,"Yes",22,13,45,23,61,16,22,45,67,"NoECE","Female","White",2.5955,20,"NoHMCSE","NoECE","OverTime"
"453","No","No",12,"No",24,12,51,27,51,0,24,51,51,"ECE","Male","White",2.5118,9,"HMCSE","ECE","OverTime"
"454","No","No",81,"No",103,22,127,24,127,0,36,60,60,"NoECE","Male","White",3.2616,0,"HMCSE","NoECE","OnTime"
"455","No","No",22,"Yes",53,31,82,29,115,33,31,60,93,"NoECE","Male","White",3.2865,0,"HMCSE","NoECE","OnTime"
"456","No","No",32,"No",41,9,65,24,87,22,28,49,70,"NoECE","Male","White",2.5066,16,"HMCSE","NoECE","OverTime"
"457","No","No",14,"No",14,0,63,49,102,39,11,45,80,"NoECE","Female","White",3.39,11,"HMCSE","NoECE","OnTime"
"458","No","No",19,"Yes",33,14,45,12,75,30,30,42,81,"NoECE","Female","White",2.3069,23,"HMCSE","NoECE","OnTime"
"459","Yes","No",27,"Yes",63,36,95,32,115,20,43,79,107,"NoECE","Female","White",2.1255,41,"HMCSE","NoECE","OverTime"
"460","No","No",13,"No",26,13,55,29,90,35,26,55,90,"NoECE","Female","NoWhite",3.3989,0,"HMCSE","NoECE","OnTime"
"461","No","No",76,"No",94,18,125,31,162,37,31,62,89,"NoECE","Female","White",3.4625,0,"HMCSE","NoECE","OnTime"
"462","No","No",16,"Yes",31,15,45,14,86,41,31,43,84,"ECE","Male","White",2.8436,2,"HMCSE","ECE","OnTime"
"463","Yes","No",12,"Yes",22,10,65,43,100,35,22,47,69,"NoECE","Female","White",2.8949,10,"HMCSE","NoECE","OverTime"
"464","Yes","No",41,"Yes",53,12,79,26,100,21,25,55,72,"NoECE","Male","White",2.6472,18,"HMCSE","NoECE","OverTime"
"465","No","No",21,"No",34,13,67,33,97,30,25,58,88,"NoECE","Male","White",3.4511,0,"HMCSE","NoECE","OnTime"
"466","Yes","No",18,"Yes",41,23,76,35,106,30,25,60,90,"NoECE","Female","NoWhite",3.5167,10,"HMCSE","NoECE","OverTime"
"467","No","No",18,"No",34,16,61,27,88,27,28,55,81,"ECE","Female","White",3.3395,4,"HMCSE","ECE","OverTime"
"468","No","No",18,"No",34,16,61,27,88,27,28,55,81,"ECE","Female","White",3.3395,4,"HMCSE","ECE","OverTime"
"469","Yes","Yes",19,"Yes",28,9,50,22,80,30,25,50,74,"NoECE","Male","NoWhite",2.6608,22,"NoHMCSE","NoECE","OverTime"
"470","No","No",17,"No",32,15,59,27,85,26,29,56,82,"NoECE","Female","White",2.8927,9,"HMCSE","NoECE","OverTime"
"471","No","No",61,"No",76,15,111,35,139,28,46,81,114,"NoECE","Female","White",3.1465,6,"HMCSE","NoECE","OnTime"
"472","No","No",22,"No",35,13,64,29,97,33,26,55,88,"NoECE","Female","NoWhite",3.2295,0,"HMCSE","NoECE","OnTime"
"473","Yes","No",74,"Yes",95,21,126,31,154,28,34,65,92,"NoECE","Male","White",3.4217,0,"HMCSE","NoECE","OnTime"
"474","No","No",66,"No",84,18,119,35,146,27,33,65,92,"NoECE","Male","White",3.7891,0,"HMCSE","NoECE","OnTime"
"475","Yes","No",25,"Yes",44,19,75,31,102,27,33,64,91,"NoECE","Male","NoWhite",3.4725,0,"HMCSE","NoECE","OnTime"
"476","No","No",45,"Yes",58,13,101,43,119,18,13,51,69,"NoECE","Male","White",3.3679,6,"HMCSE","NoECE","OnTime"
"477","No","No",52,"Yes",72,20,98,26,116,18,28,60,78,"NoECE","Male","White",3.844,0,"HMCSE","NoECE","OnTime"
"478","No","No",26,"No",39,13,64,25,88,24,26,38,62,"NoECE","Female","NoWhite",3.4919,4,"HMCSE","NoECE","OverTime"
"479","Yes","Yes",13,"Yes",26,13,56,30,63,7,26,50,64,"NoECE","Male","White",2.2953,28,"NoHMCSE","NoECE","OverTime"
"480","No","No",15,"No",35,20,65,30,108,43,35,61,86,"NoECE","Female","White",3.4081,3,"HMCSE","NoECE","OnTime"
"481","No","No",13,"No",33,20,73,40,112,39,30,70,106,"NoECE","Female","White",3.4811,0,"HMCSE","NoECE","OnTime"
"482","No","No",21,"Yes",49,28,78,29,93,15,28,57,72,"NoECE","Female","NoWhite",2.7464,6,"HMCSE","NoECE","OnTime"
"483","Yes","Yes",33,"Yes",55,22,83,28,107,24,36,61,88,"NoECE","Male","NoWhite",3.727,1,"HMCSE","NoECE","OnTime"
"484","Yes","Yes",25,"Yes",35,10,63,28,86,23,26,51,74,"NoECE","Male","NoWhite",2.2014,26,"HMCSE","NoECE","OverTime"
"485","No","No",14,"No",32,18,73,41,109,36,32,73,109,"NoECE","Female","White",3.3239,9,"HMCSE","NoECE","OnTime"
"486","No","No",9,"No",19,10,49,30,90,41,19,56,97,"ECE","Male","White",2.9247,23,"HMCSE","ECE","OverTime"
"487","Yes","No",74,"Yes",81,7,112,31,141,29,19,50,79,"NoECE","Male","White",2.4304,19,"HMCSE","NoECE","OnTime"
"488","No","No",25,"Yes",35,10,62,27,88,26,27,50,77,"NoECE","Male","White",2.346,18,"HMCSE","NoECE","OverTime"
"489","No","No",52,"No",74,22,106,32,132,26,37,69,95,"NoECE","Female","White",3.4189,0,"HMCSE","NoECE","OnTime"
"490","No","No",37,"No",56,19,83,27,114,31,36,48,79,"NoECE","Female","White",3.7278,4,"HMCSE","NoECE","OnTime"
"491","No","No",13,"No",28,15,58,30,87,29,28,54,80,"NoECE","Male","White",2.9855,0,"HMCSE","NoECE","OverTime"
"492","Yes","No",13,"No",25,12,55,30,85,30,25,55,85,"NoECE","Female","White",3.1136,12,"HMCSE","NoECE","OverTime"
"493","No","No",3,"Yes",32,29,56,24,102,46,29,53,93,"NoECE","Female","NoWhite",3.6245,0,"HMCSE","NoECE","OnTime"
"494","No","No",65,"Yes",88,23,114,26,144,30,39,65,95,"NoECE","Male","NoWhite",3.6847,0,"HMCSE","NoECE","OverTime"
"495","No","No",21,"No",67,46,87,20,108,21,29,55,76,"NoECE","Male","White",2.7921,10,"HMCSE","NoECE","OverTime"
"496","Yes","Yes",39,"Yes",61,22,87,26,121,34,30,63,97,"NoECE","Female","NoWhite",3.5728,0,"HMCSE","NoECE","OnTime"
"497","No","No",44,"Yes",53,9,77,24,111,34,14,51,82,"NoECE","Female","White",2.6267,8,"HMCSE","NoECE","OverTime"
"498","Yes","No",10,"Yes",28,18,46,18,46,0,31,52,52,"ECE","Male","White",2.0776,18,"HMCSE","NoECE","OverTime"
"499","No","No",60,"No",84,24,119,35,151,32,39,74,101,"NoECE","Male","White",3.1832,0,"HMCSE","NoECE","OnTime"
"500","No","No",12,"Yes",37,25,70,33,103,33,40,78,112,"NoECE","Male","NoWhite",2.7557,24,"HMCSE","NoECE","OnTime"
"501","No","No",27,"No",41,14,70,29,104,34,31,60,93,"NoECE","Female","White",3.2118,0,"HMCSE","NoECE","OnTime"
"502","Yes","Yes",9,"Yes",18,9,34,16,34,0,22,44,44,"NoECE","Female","NoWhite",0,22,"NoHMCSE","NoECE","OverTime"
"503","No","No",13,"No",34,21,70,36,102,32,34,70,101,"NoECE","Female","NoWhite",3.3564,0,"HMCSE","NoECE","OnTime"
"504","No","No",16,"Yes",29,13,79,50,110,31,13,60,88,"NoECE","Female","White",3.6968,0,"HMCSE","NoECE","OnTime"
"505","No","No",11,"Yes",42,31,66,24,102,36,31,64,97,"NoECE","Male","White",2.906,18,"HMCSE","NoECE","OnTime"
"506","No","No",13,"No",26,13,56,30,92,36,26,56,92,"NoECE","Female","White",2.75,8,"HMCSE","NoECE","OverTime"
"507","Yes","Yes",12,"Yes",22,10,41,19,57,16,22,47,63,"NoECE","Male","White",2.5367,24,"NoHMCSE","NoECE","OverTime"
"508","No","No",14,"Yes",26,12,51,25,73,22,26,45,76,"NoECE","Male","NoWhite",2.56,14,"HMCSE","NoECE","OverTime"
"509","No","No",18,"Yes",28,10,73,45,110,37,10,55,95,"NoECE","Male","White",2.3307,30,"HMCSE","NoECE","OnTime"
"510","No","No",31,"No",45,14,69,24,96,27,27,51,78,"NoECE","Female","White",2.8551,4,"HMCSE","NoECE","OverTime"
"511","No","No",46,"No",62,16,93,31,120,27,32,66,89,"NoECE","Male","White",2.7921,10,"HMCSE","NoECE","OnTime"
"512","Yes","No",40,"No",57,17,82,25,114,32,26,55,87,"NoECE","Female","White",3.4195,7,"HMCSE","NoECE","OnTime"
"513","No","No",39,"Yes",66,27,101,35,125,24,27,62,86,"ECE","Male","White",3.449,1,"HMCSE","ECE","OnTime"
"514","Yes","No",50,"Yes",75,25,113,38,139,26,39,77,103,"NoECE","Male","White",3.3883,1,"HMCSE","NoECE","OnTime"
"515","No","No",13,"Yes",23,10,49,26,61,12,26,52,61,"NoECE","Male","White",2.3607,3,"HMCSE","NoECE","OverTime"
"516","No","No",31,"Yes",58,27,90,32,109,19,27,59,78,"NoECE","Female","White",3.443,1,"HMCSE","NoECE","OnTime"
"517","No","No",22,"No",35,13,57,22,82,25,26,45,70,"NoECE","Female","NoWhite",2.4297,15,"HMCSE","NoECE","OverTime"
"518","No","No",20,"No",43,23,79,36,105,26,37,73,99,"NoECE","Female","White",3.9667,0,"HMCSE","NoECE","OnTime"
"519","Yes","No",13,"Yes",28,15,40,12,47,7,28,40,47,"NoECE","Male","White",2.766,26,"HMCSE","NoECE","OverTime"
"520","No","No",42,"No",67,25,100,33,128,28,39,69,97,"NoECE","Female","NoWhite",3.8969,0,"HMCSE","NoECE","OnTime"
"521","Yes","No",21,"Yes",37,16,71,34,95,24,30,67,91,"NoECE","Male","NoWhite",2.8875,10,"HMCSE","NoECE","OverTime"
"522","No","No",48,"Yes",75,27,92,17,129,37,28,66,103,"ECE","Male","White",3.4626,6,"HMCSE","ECE","OnTime"
"523","No","No",31,"No",47,16,74,27,102,28,29,56,84,"ECE","Male","White",3.2679,0,"HMCSE","ECE","OverTime"
"524","No","No",31,"No",47,16,74,27,102,28,29,56,84,"ECE","Male","White",3.2679,0,"HMCSE","ECE","OverTime"
"525","Yes","No",21,"Yes",34,13,53,19,73,20,26,51,71,"NoECE","Female","White",2.5493,10,"HMCSE","NoECE","OverTime"
"526","No","No",33,"No",50,17,89,39,116,27,25,64,91,"NoECE","Female","White",3.4516,0,"HMCSE","NoECE","OnTime"
"527","No","No",28,"No",45,17,76,31,102,26,35,65,91,"ECE","Male","White",3.0209,14,"HMCSE","ECE","OverTime"
"528","No","No",23,"No",40,17,76,36,106,30,32,68,92,"NoECE","Female","NoWhite",3.2816,0,"HMCSE","NoECE","OnTime"
"529","Yes","No",66,"Yes",82,16,114,32,6,-108,26,58,6,"NoECE","Female","White",4,0,"HMCSE","NoECE","OnTime"
"530","Yes","No",52,"Yes",73,21,106,33,138,32,35,68,101,"NoECE","Male","White",3.1604,0,"HMCSE","NoECE","OnTime"
"531","No","No",18,"No",43,25,72,29,106,34,39,68,102,"NoECE","Female","NoWhite",3.05,4,"HMCSE","NoECE","OverTime"
"532","No","No",40,"Yes",69,29,96,27,119,23,29,56,79,"ECE","Male","NoWhite",3.2228,4,"HMCSE","ECE","OnTime"
"533","No","No",27,"No",44,17,86,42,116,30,31,73,103,"ECE","Male","NoWhite",3.4864,0,"HMCSE","ECE","OverTime"
"534","No","No",27,"No",44,17,86,42,116,30,31,73,103,"ECE","Male","NoWhite",3.4864,0,"HMCSE","ECE","OverTime"
"535","Yes","No",13,"Yes",28,15,60,32,86,26,28,58,81,"ECE","Male","White",3.2235,0,"HMCSE","ECE","OverTime"
"536","Yes","No",13,"Yes",28,15,60,32,86,26,28,58,81,"ECE","Male","White",3.2235,0,"HMCSE","ECE","OverTime"
"537","No","No",11,"Yes",20,9,45,25,97,52,24,45,69,"NoECE","Male","NoWhite",3.656,16,"HMCSE","NoECE","OnTime"
"538","No","No",83,"No",102,19,125,23,18,-107,34,56,12,"NoECE","Female","NoWhite",3.45,3,"HMCSE","NoECE","OnTime"
"539","No","No",25,"No",38,13,72,34,107,35,26,60,88,"NoECE","Female","NoWhite",3.7747,0,"HMCSE","NoECE","OnTime"
"540","No","No",14,"Yes",32,18,59,27,89,30,28,59,89,"ECE","Male","White",2.8168,1,"HMCSE","ECE","OverTime"
"541","No","No",19,"No",41,22,79,38,110,31,38,76,107,"NoECE","Female","White",3.157,9,"HMCSE","NoECE","OverTime"
"542","No","No",12,"Yes",22,10,37,15,59,22,22,44,63,"NoECE","Male","NoWhite",2.7319,23,"HMCSE","NoECE","OverTime"
"543","No","No",28,"No",51,23,81,30,116,35,36,66,97,"NoECE","Female","White",3.6089,0,"HMCSE","NoECE","OverTime"
"544","No","No",16,"Yes",29,13,72,43,97,25,29,69,94,"NoECE","Male","White",3.3181,3,"HMCSE","NoECE","OnTime"
"545","No","No",59,"No",72,13,99,27,123,24,27,54,78,"NoECE","Male","White",3.9218,0,"HMCSE","NoECE","OnTime"
"546","No","No",13,"No",26,13,52,26,85,33,26,52,85,"NoECE","Male","White",3.1471,4,"HMCSE","NoECE","OverTime"
"547","Yes","No",30,"No",42,12,64,22,87,23,21,43,66,"NoECE","Male","White",2.3894,19,"HMCSE","NoECE","OverTime"
"548","Yes","No",30,"Yes",50,20,62,12,104,42,27,46,88,"ECE","Male","White",3.0935,4,"HMCSE","NoECE","OverTime"
"549","Yes","No",35,"Yes",52,17,86,34,120,34,31,65,99,"NoECE","Male","White",3.8808,0,"HMCSE","NoECE","OverTime"
"550","No","No",12,"No",27,15,49,22,82,33,30,52,82,"NoECE","Male","White",3.2378,15,"HMCSE","NoECE","OverTime"
"551","Yes","No",20,"Yes",36,16,65,29,94,29,32,61,93,"NoECE","Female","White",2.7433,32,"HMCSE","NoECE","OnTime"
"552","Yes","No",38,"Yes",38,0,38,0,93,55,13,13,29,"NoECE","Male","White",3.5033,4,"HMCSE","NoECE","OverTime"
"553","Yes","No",27,"Yes",56,29,72,16,116,44,29,45,89,"NoECE","Female","White",3.3947,3,"HMCSE","NoECE","OnTime"
"554","No","No",12,"No",25,13,60,35,92,32,25,59,91,"NoECE","Male","White",3.6407,0,"HMCSE","NoECE","OnTime"
"555","Yes","No",21,"Yes",33,12,72,39,100,28,12,51,82,"NoECE","Male","White",2.942,3,"HMCSE","NoECE","OnTime"
"556","No","No",37,"No",56,19,95,39,136,41,35,77,118,"NoECE","Female","NoWhite",3.2307,4,"HMCSE","NoECE","OnTime"
"557","No","No",37,"No",56,19,95,39,136,41,35,77,118,"NoECE","Female","NoWhite",3.2307,4,"NoHMCSE","NoECE","OnTime"
"558","Yes","Yes",45,"Yes",68,23,100,32,131,31,37,69,96,"NoECE","Male","White",3.9505,0,"HMCSE","NoECE","OnTime"
"559","No","No",23,"No",39,16,77,38,99,22,30,61,89,"ECE","Male","White",2.6,13,"HMCSE","ECE","OverTime"
"560","Yes","No",13,"Yes",47,34,78,31,112,34,37,68,98,"NoECE","Female","White",3.6704,7,"HMCSE","NoECE","OverTime"
"561","Yes","No",13,"Yes",47,34,78,31,112,34,37,68,98,"NoECE","Female","White",3.6704,7,"NoHMCSE","NoECE","OverTime"
"562","No","No",12,"No",32,20,59,27,88,29,32,56,82,"ECE","Male","White",3.1835,0,"HMCSE","ECE","OverTime"
"563","No","No",45,"No",57,12,89,32,115,26,25,57,83,"NoECE","Male","White",3.2975,4,"HMCSE","NoECE","OverTime"
"564","No","No",15,"Yes",30,15,61,31,85,24,27,52,82,"NoECE","Male","White",3.9788,0,"HMCSE","NoECE","OnTime"
"565","Yes","Yes",24,"Yes",40,16,40,0,85,45,29,29,41,"NoECE","Female","White",3.02,22,"HMCSE","NoECE","OverTime"
"566","Yes","No",13,"Yes",28,15,54,26,81,27,28,54,81,"ECE","Male","White",2.9543,0,"HMCSE","ECE","OverTime"
"567","Yes","No",19,"Yes",37,18,60,23,89,29,31,54,89,"NoECE","Female","White",2.7412,30,"HMCSE","NoECE","OverTime"
"568","No","No",90,"No",100,10,128,28,144,16,36,64,87,"NoECE","Male","White",2.5578,26,"HMCSE","NoECE","OverTime"
"569","No","No",39,"No",59,20,95,36,130,35,37,73,108,"NoECE","Female","White",2.9692,12,"HMCSE","NoECE","OnTime"
"570","Yes","Yes",14,"Yes",27,13,55,28,78,23,27,52,78,"NoECE","Female","White",2.9233,4,"HMCSE","NoECE","OverTime"
"571","No","No",40,"No",55,15,84,29,114,30,31,60,87,"ECE","Male","White",3.2189,0,"HMCSE","ECE","OverTime"
"572","No","No",23,"No",45,22,69,24,100,31,35,69,100,"NoECE","Female","NoWhite",2.201,34,"HMCSE","NoECE","OverTime"
"573","No","No",16,"No",36,20,62,26,87,25,33,67,92,"ECE","Male","NoWhite",2.8424,11,"HMCSE","ECE","OverTime"
"574","Yes","No",60,"Yes",75,15,122,47,128,6,15,62,68,"NoECE","Female","White",3.6753,0,"HMCSE","NoECE","OnTime"
"575","No","No",12,"No",28,16,60,32,93,33,28,54,80,"NoECE","Female","White",3.2226,0,"HMCSE","NoECE","OverTime"
"576","Yes","No",13,"Yes",30,17,65,35,94,29,30,65,94,"NoECE","Male","White",2.6074,6,"HMCSE","NoECE","OnTime"
"577","Yes","Yes",40,"Yes",59,19,89,30,121,32,33,63,98,"NoECE","Female","White",3.0927,8,"HMCSE","NoECE","OnTime"
"578","Yes","Yes",15,"Yes",31,16,58,27,90,32,28,58,90,"NoECE","Male","White",3.4378,4,"HMCSE","NoECE","OnTime"
"579","No","No",22,"Yes",32,10,51,19,75,24,29,48,72,"NoECE","Female","White",2.6615,22,"HMCSE","NoECE","OverTime"
"580","No","No",14,"Yes",27,13,51,24,76,25,27,51,76,"NoECE","Female","NoWhite",2.8282,9,"HMCSE","NoECE","OverTime"
"581","Yes","No",43,"Yes",56,13,92,36,124,32,26,62,94,"NoECE","Male","White",2.9585,3,"HMCSE","NoECE","OverTime"
"582","No","No",19,"Yes",47,28,62,15,102,40,28,43,83,"ECE","Male","NoWhite",3.4063,3,"HMCSE","ECE","OnTime"
"583","No","No",50,"No",64,14,98,34,122,24,28,53,86,"ECE","Male","White",3.3725,7,"HMCSE","ECE","OnTime"
"584","Yes","Yes",16,"Yes",29,13,51,22,71,20,26,48,68,"NoECE","Male","NoWhite",2.4897,23,"HMCSE","NoECE","OverTime"
"585","No","No",47,"No",72,25,108,36,153,45,42,78,120,"NoECE","Female","NoWhite",3.7975,4,"HMCSE","NoECE","OnTime"
"586","No","No",43,"Yes",56,13,88,32,116,28,26,59,90,"NoECE","Female","NoWhite",3.3089,6,"HMCSE","NoECE","OverTime"
"587","No","No",43,"Yes",56,13,88,32,116,28,26,59,90,"NoECE","Female","NoWhite",3.3089,6,"HMCSE","NoECE","OverTime"
"588","No","No",30,"No",43,13,69,26,97,28,25,51,79,"ECE","Male","White",3.7203,0,"HMCSE","ECE","OverTime"
"589","No","No",34,"Yes",52,18,79,27,105,26,30,60,86,"NoECE","Male","NoWhite",3.2109,7,"HMCSE","NoECE","OnTime"
"590","Yes","No",13,"No",26,13,61,35,88,27,26,61,89,"ECE","Male","White",3.1202,14,"HMCSE","ECE","OverTime"
"591","No","No",35,"No",52,17,80,28,112,32,30,58,90,"NoECE","Female","White",3.4211,3,"HMCSE","NoECE","OnTime"
"592","Yes","Yes",72,"Yes",83,11,112,29,140,28,23,48,75,"NoECE","Female","White",3.1707,12,"HMCSE","NoECE","OnTime"
"593","Yes","Yes",25,"Yes",49,24,75,26,111,36,41,67,100,"NoECE","Female","NoWhite",3.456,0,"HMCSE","NoECE","OnTime"
"594","No","No",17,"No",43,26,77,34,102,25,27,61,86,"NoECE","Male","White",2.564,7,"HMCSE","NoECE","OnTime"
"595","No","No",19,"No",40,21,79,39,108,29,33,72,100,"NoECE","Female","White",3.901,0,"HMCSE","NoECE","OnTime"
"596","Yes","No",29,"Yes",47,18,76,29,113,37,31,60,93,"NoECE","Male","White",3.5301,0,"HMCSE","NoECE","OverTime"
"597","Yes","No",29,"Yes",47,18,76,29,113,37,31,60,93,"NoECE","Male","White",3.5301,0,"HMCSE","NoECE","OverTime"
"598","Yes","No",43,"No",65,22,98,33,122,24,35,68,92,"ECE","Male","NoWhite",3.263,0,"HMCSE","ECE","OverTime"
"599","No","No",15,"Yes",33,18,50,17,78,28,30,55,83,"NoECE","Male","White",2.4924,12,"HMCSE","NoECE","OverTime"
"600","Yes","Yes",18,"Yes",32,14,62,30,94,32,28,58,90,"NoECE","Male","White",3.7633,3,"HMCSE","NoECE","OnTime"
"601","Yes","Yes",20,"Yes",52,32,76,24,106,30,34,61,91,"NoECE","Female","White",3.4538,3,"HMCSE","NoECE","OverTime"
"602","No","No",74,"No",89,15,132,43,160,28,29,64,92,"NoECE","Male","White",3.9228,0,"HMCSE","NoECE","OnTime"
"603","No","No",18,"No",41,23,84,43,118,34,35,71,105,"NoECE","Male","White",3.3305,4,"HMCSE","NoECE","OnTime"
"604","Yes","No",21,"Yes",32,11,51,19,76,25,27,43,68,"NoECE","Male","NoWhite",2.8732,17,"HMCSE","NoECE","OverTime"
"605","Yes","Yes",6,"Yes",28,22,48,20,79,31,31,54,91,"NoECE","Male","NoWhite",2.5055,32,"NoHMCSE","NoECE","OverTime"
"606","Yes","Yes",6,"Yes",28,22,48,20,79,31,31,54,91,"NoECE","Male","NoWhite",2.5055,32,"HMCSE","NoECE","OverTime"
"607","No","No",10,"Yes",26,16,55,29,80,25,26,52,80,"NoECE","Female","NoWhite",2.8393,14,"HMCSE","NoECE","OverTime"
"608","Yes","No",17,"Yes",41,24,76,35,103,27,38,73,99,"NoECE","Female","White",3.5,0,"HMCSE","NoECE","OnTime"
"609","No","No",0,"Yes",18,18,18,0,18,0,30,30,30,"NoECE","Female","White",1.96,12,"HMCSE","NoECE","OverTime"
"610","No","No",19,"No",38,19,72,34,101,29,32,66,95,"NoECE","Female","White",3.7916,0,"HMCSE","NoECE","OverTime"
"611","No","No",15,"No",30,15,59,29,79,20,30,59,79,"NoECE","Male","White",3.2684,7,"HMCSE","NoECE","OverTime"
"612","Yes","Yes",13,"Yes",25,12,49,24,75,26,25,46,72,"NoECE","Female","White",2.4778,12,"NoHMCSE","NoECE","OverTime"
"613","Yes","Yes",13,"Yes",25,12,49,24,75,26,25,46,72,"NoECE","Female","White",2.4778,12,"HMCSE","NoECE","OverTime"
"614","Yes","No",13,"Yes",32,19,61,29,95,34,32,61,95,"NoECE","Male","NoWhite",3.3116,0,"HMCSE","NoECE","OverTime"
"615","Yes","Yes",25,"Yes",38,13,73,35,103,30,16,44,74,"NoECE","Female","White",3.0973,11,"HMCSE","NoECE","OverTime"
"616","Yes","No",26,"Yes",52,26,89,37,111,22,26,63,85,"NoECE","Female","NoWhite",3.6959,0,"HMCSE","NoECE","OnTime"
"617","No","No",0,"Yes",16,16,58,42,83,25,16,58,83,"NoECE","Female","White",3.5169,9,"HMCSE","NoECE","OnTime"
"618","No","No",13,"No",32,19,66,34,92,26,32,66,92,"NoECE","Female","White",3.0641,0,"HMCSE","NoECE","OverTime"
"619","No","No",13,"No",34,21,51,17,73,22,34,58,76,"NoECE","Female","White",2.2763,29,"HMCSE","NoECE","OverTime"
"620","Yes","No",4,"Yes",29,25,60,31,93,33,25,56,89,"NoECE","Male","White",3.7772,0,"HMCSE","NoECE","OnTime"
"621","Yes","No",19,"No",44,25,77,33,114,37,38,71,108,"NoECE","Male","White",3.7824,0,"HMCSE","NoECE","OnTime"
"622","Yes","Yes",54,"Yes",61,7,79,18,79,0,26,44,52,"NoECE","Male","White",1.9511,14,"NoHMCSE","NoECE","OverTime"
"623","Yes","Yes",14,"Yes",28,14,48,20,69,21,28,60,90,"NoECE","Male","NoWhite",1.8422,44,"NoHMCSE","NoECE","OverTime"
"624","No","No",60,"No",81,21,107,26,135,28,38,63,91,"NoECE","Female","White",3.6198,0,"HMCSE","NoECE","OnTime"
"625","No","No",46,"Yes",57,11,79,22,97,18,27,49,70,"NoECE","Male","NoWhite",2.2672,27,"HMCSE","NoECE","OverTime"
"626","No","No",76,"No",92,16,120,28,148,28,31,59,87,"NoECE","Male","White",3.6816,0,"HMCSE","NoECE","OnTime"
"627","Yes","No",30,"Yes",57,27,90,33,125,35,27,60,95,"NoECE","Female","White",3.4857,4,"HMCSE","NoECE","OnTime"
"628","Yes","No",28,"Yes",56,28,90,34,113,23,56,90,113,"NoECE","Male","White",3.9414,0,"HMCSE","NoECE","OnTime"
"629","No","No",27,"No",48,21,81,33,105,24,33,59,90,"NoECE","Female","White",3.149,0,"HMCSE","NoECE","OnTime"
"630","No","No",34,"No",60,26,95,35,120,25,27,61,85,"NoECE","Male","White",3.9459,0,"HMCSE","NoECE","OverTime"
"631","Yes","No",12,"Yes",27,15,54,27,78,24,27,54,78,"NoECE","Female","White",3.5654,0,"HMCSE","NoECE","OverTime"
"632","Yes","No",29,"No",42,13,75,33,75,0,27,60,60,"NoECE","Female","NoWhite",3.6083,3,"HMCSE","NoECE","OverTime"
"633","Yes","Yes",25,"Yes",38,13,62,24,93,31,26,50,81,"NoECE","Female","NoWhite",3.0977,0,"HMCSE","NoECE","OnTime"
"634","Yes","Yes",29,"Yes",42,13,66,24,84,18,25,49,67,"NoECE","Male","White",2.9627,0,"NoHMCSE","NoECE","OnTime"
"635","Yes","No",13,"Yes",33,20,62,29,62,0,33,62,62,"ECE","Female","White",3.9548,3,"HMCSE","ECE","OverTime"
"636","Yes","No",78,"Yes",96,18,124,28,153,29,29,61,90,"ECE","Male","White",3.4419,0,"HMCSE","ECE","OnTime"
"637","No","No",63,"No",81,18,116,35,150,34,34,69,93,"NoECE","Female","White",3.6786,0,"HMCSE","NoECE","OnTime"
"638","No","No",6,"Yes",37,31,67,30,86,19,31,61,80,"NoECE","Male","NoWhite",3.6315,0,"HMCSE","NoECE","OnTime"
"639","No","No",27,"Yes",50,23,75,25,109,34,28,63,97,"ECE","Male","White",3.2,0,"HMCSE","ECE","OnTime"
"640","No","No",12,"No",27,15,54,27,80,26,27,51,74,"NoECE","Male","NoWhite",2.7247,13,"HMCSE","NoECE","OnTime"
"641","No","No",28,"No",41,13,73,32,111,38,26,58,96,"NoECE","Female","White",3.0354,0,"HMCSE","NoECE","OnTime"
"642","No","No",13,"Yes",35,22,66,31,81,15,26,64,79,"NoECE","Male","NoWhite",3.5707,0,"HMCSE","NoECE","OnTime"
"643","No","No",99,"Yes",123,24,155,32,176,21,36,68,95,"NoECE","Male","NoWhite",2.5421,15,"HMCSE","NoECE","OverTime"
"644","No","No",9,"No",25,16,59,34,87,28,25,59,87,"NoECE","Female","White",3.1046,4,"HMCSE","NoECE","OverTime"
"645","Yes","No",9,"Yes",25,16,43,18,55,12,31,43,55,"NoECE","Male","White",2.2814,24,"HMCSE","NoECE","OverTime"
"646","No","No",17,"No",30,13,59,29,92,33,27,56,84,"NoECE","Male","White",2.1226,16,"HMCSE","NoECE","OverTime"
"647","Yes","No",13,"No",25,12,55,30,89,34,28,58,85,"NoECE","Female","NoWhite",2.9235,9,"HMCSE","NoECE","OnTime"
"648","No","No",19,"Yes",29,10,42,13,70,28,26,40,75,"NoECE","Female","NoWhite",2.2202,17,"HMCSE","NoECE","OverTime"
"649","No","No",87,"Yes",99,12,126,27,6,-120,12,36,6,"NoECE","Male","White",4,0,"HMCSE","NoECE","OnTime"
"650","No","No",31,"Yes",47,16,71,24,100,29,28,56,86,"ECE","Female","White",3.3419,0,"HMCSE","ECE","OverTime"
"651","No","No",52,"No",66,14,96,30,128,32,27,54,83,"NoECE","Female","NoWhite",4,0,"HMCSE","NoECE","OnTime"
"652","No","No",13,"No",26,13,56,30,89,33,26,56,89,"NoECE","Male","White",3.0449,8,"HMCSE","NoECE","OnTime"
"653","No","No",27,"No",42,15,63,21,95,32,28,53,79,"NoECE","Male","White",3.0153,7,"HMCSE","NoECE","OverTime"
"654","Yes","No",23,"Yes",38,15,76,38,106,30,28,60,96,"NoECE","Female","White",3.6931,4,"HMCSE","NoECE","OnTime"
"655","No","No",24,"No",39,15,66,27,88,22,27,58,84,"NoECE","Male","NoWhite",2.5202,25,"HMCSE","NoECE","OverTime"
"656","No","No",16,"No",35,19,66,31,100,34,35,66,100,"NoECE","Female","White",3.28,0,"HMCSE","NoECE","OnTime"
"657","No","No",13,"Yes",26,13,52,26,79,27,26,53,83,"NoECE","Female","NoWhite",3.4667,0,"HMCSE","NoECE","OverTime"
"658","No","No",30,"No",44,14,87,43,118,31,27,67,97,"NoECE","Female","White",3.333,0,"HMCSE","NoECE","OnTime"
"659","No","No",18,"No",31,13,62,31,94,32,26,57,83,"NoECE","Female","White",2.7791,7,"HMCSE","NoECE","OverTime"
"660","No","No",65,"Yes",78,13,110,32,127,17,13,45,62,"NoECE","Female","White",3.3734,0,"HMCSE","NoECE","OnTime"
"661","Yes","No",49,"Yes",67,18,98,31,126,28,31,62,87,"NoECE","Male","White",3.2299,0,"HMCSE","NoECE","OnTime"
"662","No","No",54,"No",70,16,97,27,129,32,30,57,86,"NoECE","Female","White",3.2876,0,"HMCSE","NoECE","OnTime"
"663","Yes","No",52,"Yes",68,16,97,29,130,33,29,58,88,"NoECE","Female","White",4,0,"HMCSE","NoECE","OnTime"
"664","No","No",70,"No",84,14,113,29,120,7,23,55,62,"NoECE","Male","White",3.1587,1,"HMCSE","NoECE","OnTime"
"665","Yes","Yes",10,"Yes",22,12,45,23,84,39,25,52,91,"NoECE","Female","NoWhite",2.7505,25,"NoHMCSE","NoECE","OverTime"
"666","No","No",74,"No",90,16,118,28,151,33,28,56,89,"NoECE","Male","White",3.8831,0,"HMCSE","NoECE","OnTime"
"667","No","No",114,"No",133,19,163,30,189,26,33,63,89,"NoECE","Female","NoWhite",3.2382,4,"HMCSE","NoECE","OverTime"
"668","No","No",52,"Yes",69,17,84,15,0,-84,28,46,0,"NoECE","Female","White",3,0,"HMCSE","NoECE","OnTime"
"669","Yes","Yes",16,"Yes",32,16,72,40,98,26,29,68,97,"NoECE","Female","NoWhite",3.0495,13,"NoHMCSE","NoECE","OverTime"
"670","Yes","No",9,"Yes",30,21,59,29,84,25,34,63,91,"NoECE","Female","White",2.989,17,"HMCSE","NoECE","OverTime"
"671","No","No",13,"No",36,23,72,36,100,28,36,72,100,"ECE","Male","White",3.9255,0,"HMCSE","ECE","OverTime"
"672","No","No",18,"No",38,20,74,36,94,20,32,64,88,"NoECE","Female","NoWhite",3.4398,8,"HMCSE","NoECE","OnTime"
"673","Yes","No",30,"Yes",49,19,70,21,82,12,32,53,65,"NoECE","Female","White",3.1743,6,"HMCSE","NoECE","OverTime"
"674","Yes","No",17,"Yes",26,9,64,38,86,22,26,49,78,"NoECE","Male","NoWhite",3.2214,10,"HMCSE","NoECE","OnTime"
"675","No","No",16,"No",35,19,57,22,75,18,35,57,78,"NoECE","Male","White",2.66,11,"HMCSE","NoECE","OverTime"
"676","No","No",14,"No",32,18,59,27,84,25,32,59,83,"NoECE","Male","NoWhite",3.275,0,"HMCSE","NoECE","OnTime"
"677","No","No",12,"No",25,13,45,20,75,30,25,51,81,"NoECE","Female","NoWhite",2.3494,26,"HMCSE","NoECE","OverTime"
"678","Yes","No",30,"Yes",44,14,66,22,82,16,28,54,70,"NoECE","Male","NoWhite",3.5776,0,"HMCSE","NoECE","OverTime"
"679","No","No",19,"No",39,20,69,30,97,28,33,63,91,"NoECE","Male","White",3.5912,0,"HMCSE","NoECE","OnTime"
"680","Yes","No",33,"Yes",55,22,82,27,103,21,36,63,84,"NoECE","Male","White",3.1791,4,"HMCSE","NoECE","OnTime"
"681","No","No",101,"No",114,13,143,29,158,15,25,54,69,"ECE","Male","NoWhite",3.8373,0,"HMCSE","ECE","OnTime"
"682","No","No",101,"No",114,13,143,29,158,15,25,54,69,"ECE","Male","NoWhite",3.8373,0,"HMCSE","ECE","OnTime"
"683","No","No",40,"No",58,18,86,28,115,29,33,61,90,"NoECE","Male","White",3.4978,0,"HMCSE","NoECE","OverTime"
"684","Yes","Yes",12,"Yes",27,15,49,22,45,-4,27,52,59,"ECE","Male","White",2.478,21,"HMCSE","ECE","OverTime"
"685","No","No",23,"Yes",36,13,71,35,101,30,13,48,78,"NoECE","Female","White",2.8333,5,"HMCSE","NoECE","OnTime"
"686","No","No",14,"Yes",29,15,52,23,78,26,29,55,78,"NoECE","Male","NoWhite",2.5543,16,"HMCSE","NoECE","OverTime"
"687","No","No",77,"Yes",101,24,119,18,156,37,24,42,79,"NoECE","Female","NoWhite",3.1876,3,"HMCSE","NoECE","OnTime"
"688","No","No",27,"No",40,13,78,38,109,31,28,63,93,"NoECE","Female","White",3.5548,0,"HMCSE","NoECE","OnTime"
"689","No","No",23,"No",38,15,52,14,93,41,35,49,90,"ECE","Male","White",3.98,0,"HMCSE","ECE","OverTime"
"690","No","No",45,"No",61,16,86,25,101,15,31,56,71,"NoECE","Male","White",3.2155,16,"HMCSE","NoECE","OnTime"
"691","No","No",35,"No",51,16,88,37,121,33,31,68,101,"NoECE","Female","White",3.705,0,"HMCSE","NoECE","OverTime"
"692","No","No",35,"No",51,16,88,37,121,33,31,68,101,"NoECE","Female","White",3.705,0,"HMCSE","NoECE","OverTime"
"693","No","No",30,"No",50,20,78,28,107,29,32,60,88,"NoECE","Female","NoWhite",3.6956,0,"HMCSE","NoECE","OnTime"
"694","Yes","No",39,"Yes",56,17,88,32,115,27,30,62,89,"NoECE","Female","White",3.9393,6,"HMCSE","NoECE","OnTime"
"695","No","No",25,"No",37,12,68,31,90,22,28,59,81,"NoECE","Male","White",3.6617,3,"HMCSE","NoECE","OverTime"
"696","Yes","Yes",13,"Yes",29,16,43,14,55,12,29,53,68,"NoECE","Male","NoWhite",2.1441,23,"NoHMCSE","NoECE","OverTime"
"697","No","No",13,"No",33,20,62,29,90,28,33,62,87,"ECE","Male","White",3.4833,0,"HMCSE","ECE","OverTime"
"698","No","No",37,"No",50,13,76,26,106,30,27,53,79,"NoECE","Male","White",3.5193,0,"HMCSE","NoECE","OnTime"
"699","No","No",37,"No",50,13,76,26,106,30,27,53,79,"NoECE","Male","White",3.5193,0,"HMCSE","NoECE","OnTime"
"700","No","No",57,"No",74,17,110,36,139,29,29,59,87,"NoECE","Female","NoWhite",3.6126,4,"HMCSE","NoECE","OnTime"
"701","Yes","No",6,"Yes",35,29,61,26,94,33,29,55,88,"NoECE","Male","NoWhite",3.2375,13,"HMCSE","NoECE","OnTime"
"702","No","No",15,"No",43,28,78,35,123,45,40,75,120,"NoECE","Male","NoWhite",3.5333,3,"NoHMCSE","NoECE","OverTime"
"703","No","No",15,"No",43,28,78,35,123,45,40,75,120,"NoECE","Male","NoWhite",3.5333,3,"HMCSE","NoECE","OverTime"
"704","No","No",40,"No",59,19,87,28,127,40,36,68,100,"NoECE","Female","White",3.0317,3,"HMCSE","NoECE","OnTime"
"705","Yes","Yes",16,"Yes",29,13,56,27,64,8,33,60,64,"NoECE","Female","White",2.6156,30,"NoHMCSE","NoECE","OverTime"
"706","No","No",15,"No",31,16,53,22,90,37,28,54,87,"NoECE","Female","White",3.1437,4,"HMCSE","NoECE","OverTime"
"707","Yes","Yes",14,"Yes",34,20,67,33,98,31,28,61,86,"NoECE","Female","White",3.3556,7,"HMCSE","NoECE","OnTime"
"708","No","No",14,"No",31,17,66,35,96,30,31,66,99,"NoECE","Male","White",2.5283,18,"HMCSE","NoECE","OverTime"
"709","No","No",23,"No",42,19,75,33,102,27,33,60,87,"NoECE","Female","White",3.292,4,"HMCSE","NoECE","OnTime"
"710","Yes","Yes",12,"Yes",31,19,64,33,90,26,31,64,90,"NoECE","Male","White",3.2511,3,"HMCSE","NoECE","OverTime"
"711","No","No",42,"No",60,18,96,36,124,28,31,67,95,"NoECE","Male","White",3.9042,0,"HMCSE","NoECE","OnTime"
"712","No","No",35,"No",51,16,88,37,119,31,48,85,120,"NoECE","Female","White",3.015,10,"HMCSE","NoECE","OnTime"
"713","No","No",18,"No",46,28,70,24,97,27,37,61,88,"NoECE","Male","White",3.5159,7,"HMCSE","NoECE","OnTime"
"714","Yes","No",45,"No",60,15,86,26,110,24,29,56,84,"ECE","Male","White",2.9405,9,"HMCSE","ECE","OverTime"
"715","No","No",77,"No",86,9,114,28,140,26,25,53,79,"NoECE","Female","NoWhite",3.1266,3,"HMCSE","NoECE","OnTime"
"716","No","No",12,"Yes",33,21,64,31,94,30,33,64,94,"NoECE","Male","NoWhite",3.0777,0,"HMCSE","NoECE","OnTime"
"717","Yes","No",34,"Yes",48,14,80,32,120,40,27,56,95,"NoECE","Male","White",3.2305,0,"HMCSE","NoECE","OnTime"
"718","No","No",61,"No",79,18,104,25,129,25,32,57,81,"NoECE","Female","White",3.6617,0,"HMCSE","NoECE","OnTime"
"719","Yes","No",40,"Yes",52,12,77,25,107,30,25,50,76,"NoECE","Male","White",3.1921,10,"HMCSE","NoECE","OnTime"
"720","No","No",24,"No",34,10,56,22,85,29,31,61,87,"ECE","Male","White",3.0964,6,"HMCSE","NoECE","OverTime"
"721","No","No",36,"No",51,15,78,27,105,27,28,55,82,"NoECE","Male","White",3.6573,0,"HMCSE","NoECE","OnTime"
"722","Yes","No",49,"Yes",75,26,103,28,135,32,26,54,85,"ECE","Female","White",3.2602,3,"HMCSE","ECE","OnTime"
"723","No","No",12,"Yes",25,13,52,27,64,12,25,52,64,"NoECE","Male","NoWhite",3.0269,0,"HMCSE","NoECE","OverTime"
"724","No","No",14,"Yes",28,14,54,26,66,12,28,54,66,"NoECE","Female","NoWhite",2.7488,11,"HMCSE","NoECE","OverTime"
"725","No","No",83,"Yes",113,30,149,36,152,3,30,66,69,"NoECE","Female","White",3.621,0,"HMCSE","NoECE","OnTime"
"726","No","Yes",13,"Yes",26,13,58,32,95,37,26,61,95,"NoECE","Female","White",3.64,3,"HMCSE","NoECE","OnTime"
"727","No","No",19,"Yes",46,27,86,40,119,33,27,67,99,"ECE","Male","NoWhite",3.6808,0,"HMCSE","ECE","OnTime"
"728","Yes","No",43,"Yes",64,21,84,20,112,28,25,53,81,"NoECE","Female","White",3.0169,18,"HMCSE","NoECE","OnTime"
"729","No","No",13,"No",28,15,68,40,98,30,28,68,95,"NoECE","Male","White",3.111,4,"HMCSE","NoECE","OverTime"
"730","No","No",47,"No",70,23,105,35,134,29,37,72,100,"ECE","Male","NoWhite",3.826,0,"HMCSE","ECE","OnTime"
"731","No","No",54,"No",54,0,73,19,95,22,0,7,18,"ECE","Male","NoWhite",2.6722,18,"HMCSE","ECE","OverTime"
"732","Yes","No",40,"Yes",54,14,79,25,116,37,30,52,89,"NoECE","Male","White",3.3416,17,"HMCSE","NoECE","OnTime"
"733","No","No",23,"No",35,12,70,35,107,37,25,60,97,"NoECE","Female","White",2.8175,15,"HMCSE","NoECE","OverTime"
"734","No","No",15,"No",30,15,67,37,102,35,30,67,102,"NoECE","Male","NoWhite",3.1245,0,"HMCSE","NoECE","OverTime"
"735","Yes","No",54,"Yes",74,20,101,27,134,33,28,62,95,"NoECE","Male","White",3.8143,0,"HMCSE","NoECE","OnTime"
"736","Yes","No",22,"No",43,21,74,31,117,43,34,65,108,"NoECE","Female","NoWhite",3.3139,3,"HMCSE","NoECE","OnTime"
"737","Yes","No",33,"Yes",51,18,75,24,84,9,31,58,74,"ECE","Male","White",2.123,24,"HMCSE","NoECE","OverTime"
"738","Yes","No",12,"Yes",25,13,45,20,74,29,26,46,75,"NoECE","Male","White",2.8587,26,"HMCSE","NoECE","OverTime"
"739","No","No",12,"No",30,18,60,30,90,30,30,60,93,"ECE","Male","NoWhite",2.9495,0,"HMCSE","ECE","OverTime"
"740","Yes","No",13,"Yes",30,17,61,31,100,39,30,61,90,"ECE","Male","NoWhite",3.048,0,"HMCSE","ECE","OnTime"
"741","Yes","No",26,"Yes",42,16,52,10,92,40,25,39,79,"ECE","Male","NoWhite",3.5266,6,"HMCSE","NoECE","OnTime"
"742","No","No",14,"No",32,18,69,37,91,22,32,69,98,"NoECE","Female","White",2.7053,16,"HMCSE","NoECE","OverTime"
"743","No","No",13,"No",29,16,48,19,76,28,33,58,93,"NoECE","Female","White",1.9237,23,"HMCSE","NoECE","OverTime"
"744","No","No",14,"No",33,19,71,38,111,40,33,71,108,"NoECE","Male","White",3.5602,0,"HMCSE","NoECE","OnTime"
"745","Yes","No",18,"Yes",33,15,71,38,105,34,15,53,86,"NoECE","Female","White",3.5157,4,"HMCSE","NoECE","OnTime"
"746","No","No",15,"Yes",33,18,39,6,68,29,24,44,76,"NoECE","Male","White",2.5045,27,"HMCSE","NoECE","OnTime"
"747","Yes","No",13,"Yes",25,12,53,28,79,26,25,53,77,"NoECE","Male","NoWhite",3.3169,4,"HMCSE","NoECE","OverTime"
"748","No","No",39,"No",58,19,84,26,108,24,32,58,86,"NoECE","Male","White",2.8354,10,"HMCSE","NoECE","OnTime"
"749","No","No",34,"No",51,17,81,30,111,30,30,60,90,"ECE","Female","NoWhite",3.4811,0,"HMCSE","ECE","OverTime"
"750","No","No",18,"No",30,12,62,32,103,41,24,53,94,"NoECE","Female","White",3.3263,6,"HMCSE","NoECE","OnTime"
"751","No","No",15,"No",37,22,64,27,99,35,37,67,102,"NoECE","Male","NoWhite",3.0824,6,"HMCSE","NoECE","OnTime"
"752","No","No",15,"No",30,15,57,27,87,30,30,57,87,"NoECE","Female","NoWhite",3.4333,0,"HMCSE","NoECE","OverTime"
"753","No","No",61,"Yes",80,19,110,30,130,20,30,64,84,"NoECE","Female","White",3.925,0,"HMCSE","NoECE","OnTime"
"754","No","No",9,"No",39,30,73,34,114,41,39,70,98,"NoECE","Female","White",2.9766,15,"HMCSE","NoECE","OnTime"
"755","No","No",13,"Yes",29,16,40,11,80,40,29,40,80,"NoECE","Male","White",2.9157,6,"HMCSE","NoECE","OnTime"
"756","Yes","No",10,"Yes",25,15,49,24,73,24,25,52,76,"NoECE","Male","NoWhite",2.7049,16,"HMCSE","NoECE","OverTime"
"757","No","No",16,"No",39,23,76,37,115,39,39,76,115,"NoECE","Male","White",3.6643,0,"HMCSE","NoECE","OnTime"
"758","Yes","Yes",43,"Yes",64,21,97,33,128,31,34,63,102,"NoECE","Female","NoWhite",3.6063,0,"HMCSE","NoECE","OnTime"
"759","No","No",19,"No",35,16,74,39,98,24,32,71,95,"NoECE","Female","White",3.6137,4,"HMCSE","NoECE","OverTime"
"760","No","No",13,"No",26,13,56,30,93,37,25,52,89,"NoECE","Male","NoWhite",2.9629,18,"HMCSE","NoECE","OnTime"
"761","No","No",47,"Yes",74,27,120,46,120,0,27,72,72,"NoECE","Male","White",3.8218,0,"HMCSE","NoECE","OnTime"
"762","No","No",42,"No",56,14,86,30,115,29,28,58,87,"ECE","Male","White",3.4184,0,"HMCSE","ECE","OverTime"
"763","No","No",42,"No",56,14,86,30,115,29,28,58,87,"ECE","Male","White",3.4184,0,"HMCSE","ECE","OverTime"
"764","Yes","No",15,"Yes",29,14,60,31,83,23,29,56,83,"ECE","Female","White",3.2253,3,"HMCSE","ECE","OverTime"
"765","No","No",13,"Yes",55,42,98,43,6,-92,43,92,6,"NoECE","Male","White",3.575,4,"HMCSE","NoECE","OnTime"
"766","No","No",32,"No",49,17,78,29,116,38,30,59,86,"NoECE","Male","NoWhite",3.8175,0,"HMCSE","NoECE","OnTime"
"767","Yes","No",13,"Yes",29,16,56,27,84,28,29,56,90,"NoECE","Male","White",2.6856,6,"HMCSE","NoECE","OverTime"
"768","No","No",26,"Yes",52,26,83,31,122,39,26,57,96,"ECE","Male","White",3.4067,4,"HMCSE","ECE","OnTime"
"769","No","No",19,"No",35,16,68,33,90,22,30,66,91,"NoECE","Male","NoWhite",2.6912,13,"HMCSE","NoECE","OverTime"
"770","No","No",6,"Yes",31,25,47,16,89,42,25,41,79,"NoECE","Female","NoWhite",3.306,0,"HMCSE","NoECE","OnTime"
"771","No","No",56,"No",68,12,94,26,123,29,24,49,77,"NoECE","Female","White",3.274,3,"HMCSE","NoECE","OverTime"
"772","No","No",18,"Yes",43,25,71,28,99,28,25,53,81,"NoECE","Female","White",3.281,9,"HMCSE","NoECE","OnTime"
"773","Yes","Yes",19,"Yes",41,22,84,43,119,35,35,73,108,"NoECE","Female","NoWhite",3.3796,7,"HMCSE","NoECE","OverTime"
"774","No","No",12,"No",31,19,64,33,99,35,31,64,101,"NoECE","Female","White",2.5693,14,"HMCSE","NoECE","OverTime"
"775","Yes","Yes",12,"Yes",32,20,64,32,92,28,32,61,92,"NoECE","Male","White",3.3957,0,"HMCSE","NoECE","OverTime"
"776","Yes","No",27,"Yes",40,13,67,27,93,26,21,52,77,"ECE","Female","White",3.7391,4,"HMCSE","ECE","OverTime"
"777","Yes","No",22,"Yes",40,18,68,28,75,7,28,58,65,"NoECE","Female","White",2.9896,20,"HMCSE","NoECE","OverTime"
"778","No","No",45,"Yes",54,9,54,0,54,0,26,26,26,"NoECE","Male","NoWhite",2.1783,10,"HMCSE","NoECE","OverTime"
"779","No","No",21,"No",39,18,74,35,115,41,32,67,107,"NoECE","Female","White",3.3692,0,"HMCSE","NoECE","OnTime"
"780","Yes","Yes",23,"Yes",38,15,68,30,93,25,31,61,82,"ECE","Male","White",3.5329,4,"HMCSE","ECE","OverTime"
"781","Yes","No",21,"Yes",31,10,64,33,88,24,28,54,81,"NoECE","Male","White",3.4046,0,"HMCSE","NoECE","OnTime"
"782","No","No",42,"No",63,21,92,29,122,30,34,62,90,"NoECE","Male","White",3.5696,0,"HMCSE","NoECE","OnTime"
"783","No","No",37,"Yes",47,10,59,12,59,0,26,38,38,"NoECE","Female","White",2.3447,19,"HMCSE","NoECE","OverTime"
"784","No","No",96,"No",108,12,142,34,157,15,24,58,73,"NoECE","Male","White",3.5965,0,"HMCSE","NoECE","OnTime"
"785","No","No",21,"Yes",31,10,56,25,95,39,28,53,88,"NoECE","Female","NoWhite",2.806,16,"HMCSE","NoECE","OnTime"
"786","No","No",65,"No",79,14,115,36,151,36,28,64,100,"NoECE","Female","White",3.662,0,"HMCSE","NoECE","OnTime"
"787","No","No",14,"Yes",30,16,58,28,89,31,27,58,90,"NoECE","Female","White",2.9606,1,"HMCSE","NoECE","OnTime"
"788","No","No",26,"No",42,16,75,33,108,33,29,62,95,"NoECE","Male","White",3.9042,3,"HMCSE","NoECE","OnTime"
"789","Yes","No",13,"Yes",22,9,45,23,62,17,22,48,63,"NoECE","Female","White",2.6536,28,"HMCSE","NoECE","OverTime"
"790","No","No",49,"No",65,16,95,30,121,26,32,62,88,"NoECE","Male","White",3.1364,14,"HMCSE","NoECE","OverTime"
"791","Yes","Yes",20,"Yes",42,22,66,24,72,6,36,63,76,"NoECE","Female","White",2.2544,32,"NoHMCSE","NoECE","OverTime"
"792","No","No",12,"No",28,16,56,28,88,32,28,56,85,"NoECE","Female","White",3.2463,0,"HMCSE","NoECE","OnTime"
"793","Yes","No",3,"Yes",27,24,59,32,83,24,24,56,80,"NoECE","Female","White",2.7928,6,"HMCSE","NoECE","OnTime"
"794","No","No",74,"No",87,13,99,12,138,39,26,38,77,"NoECE","Male","NoWhite",3.6701,0,"HMCSE","NoECE","OnTime"
"795","No","No",64,"No",78,14,105,27,126,21,28,55,76,"NoECE","Female","White",3.9899,0,"HMCSE","NoECE","OnTime"
"796","Yes","Yes",19,"Yes",41,22,68,27,105,37,38,65,106,"NoECE","Female","White",3.0078,7,"HMCSE","NoECE","OnTime"
"797","No","No",6,"Yes",29,23,58,29,88,30,23,52,82,"NoECE","Female","White",3.0202,3,"HMCSE","NoECE","OnTime"
"798","No","No",13,"No",28,15,51,23,81,30,28,51,81,"NoECE","Male","NoWhite",3,10,"HMCSE","NoECE","OverTime"
"799","No","No",93,"No",107,14,123,16,152,29,29,45,74,"ECE","Male","White",2.7189,10,"HMCSE","ECE","OverTime"
"800","No","No",8,"No",8,0,8,0,8,0,18,18,18,"NoECE","Male","NoWhite",0,27,"HMCSE","NoECE","OverTime"
"801","No","No",38,"No",60,22,100,40,127,27,36,76,103,"ECE","Male","White",3.9621,0,"HMCSE","ECE","OnTime"
"802","No","No",64,"Yes",92,28,134,42,134,0,24,66,66,"NoECE","Male","White",3.825,4,"HMCSE","NoECE","OnTime"
"803","Yes","Yes",34,"Yes",54,20,79,25,93,14,28,59,73,"NoECE","Female","NoWhite",3.7722,0,"HMCSE","NoECE","OnTime"
"804","No","No",43,"Yes",64,21,87,23,116,29,34,61,93,"NoECE","Male","White",3.7448,0,"HMCSE","NoECE","OverTime"
"805","No","No",37,"No",64,27,107,43,142,35,43,86,121,"ECE","Male","NoWhite",3.0686,10,"HMCSE","ECE","OnTime"
"806","No","No",22,"Yes",35,13,52,17,73,21,26,42,67,"NoECE","Female","NoWhite",2.9901,20,"HMCSE","NoECE","OverTime"
"807","Yes","Yes",44,"Yes",58,14,97,39,134,37,30,69,106,"NoECE","Female","White",3.6509,0,"HMCSE","NoECE","OnTime"
"808","No","No",13,"No",32,19,67,35,105,38,32,67,105,"NoECE","Female","NoWhite",3.8714,0,"HMCSE","NoECE","OnTime"
"809","No","No",9,"Yes",19,10,52,33,75,23,13,43,66,"NoECE","Male","White",2.959,16,"HMCSE","NoECE","OnTime"
"810","Yes","Yes",39,"Yes",53,14,91,38,115,24,31,66,101,"NoECE","Female","NoWhite",2.795,18,"NoHMCSE","NoECE","OverTime"
"811","Yes","Yes",39,"Yes",53,14,91,38,115,24,31,66,101,"NoECE","Female","NoWhite",2.795,18,"NoHMCSE","NoECE","OverTime"
"812","Yes","No",37,"Yes",49,12,62,13,77,15,24,33,51,"NoECE","Male","NoWhite",2.3294,15,"HMCSE","NoECE","OverTime"
"813","No","No",63,"No",82,19,115,33,127,12,33,62,78,"NoECE","Male","White",3.7922,0,"HMCSE","NoECE","OnTime"
"814","Yes","Yes",18,"Yes",30,12,55,25,69,14,27,55,78,"ECE","Male","White",2.0115,23,"NoHMCSE","NoECE","OverTime"
"815","No","No",37,"Yes",55,18,78,23,104,26,34,57,87,"NoECE","Male","NoWhite",3.3156,3,"HMCSE","NoECE","OverTime"
"816","No","No",19,"No",32,13,60,28,83,23,27,59,84,"NoECE","Female","White",2.9083,12,"HMCSE","NoECE","OverTime"
"817","No","No",22,"No",48,26,86,38,121,35,42,80,115,"ECE","Male","White",4,0,"HMCSE","ECE","OnTime"
"818","No","No",15,"Yes",28,13,68,40,102,34,13,53,87,"NoECE","Female","White",3.7064,0,"HMCSE","NoECE","OnTime"
"819","No","No",43,"No",56,13,90,34,123,33,26,60,93,"NoECE","Male","White",3.1731,0,"HMCSE","NoECE","OnTime"
"820","No","No",36,"No",61,25,92,31,132,40,38,69,109,"NoECE","Male","White",4,0,"HMCSE","NoECE","OnTime"
"821","No","No",36,"No",61,25,92,31,132,40,38,69,109,"NoECE","Male","White",4,0,"HMCSE","NoECE","OnTime"
"822","Yes","Yes",13,"Yes",26,13,53,27,69,16,26,57,83,"NoECE","Male","NoWhite",2.2193,29,"NoHMCSE","NoECE","OverTime"
"823","No","No",19,"No",35,16,67,32,95,28,29,61,89,"ECE","Female","White",3.9562,0,"HMCSE","ECE","OverTime"
"824","No","No",14,"No",42,28,79,37,108,29,42,79,107,"NoECE","Female","NoWhite",3.6776,0,"HMCSE","NoECE","OnTime"
"825","No","No",9,"Yes",29,20,60,31,87,27,29,60,83,"NoECE","Female","White",2.758,14,"HMCSE","NoECE","OverTime"
"826","Yes","No",13,"Yes",31,18,61,30,68,7,31,57,71,"NoECE","Male","White",2.6487,6,"HMCSE","NoECE","OverTime"
"827","Yes","No",27,"Yes",47,20,70,23,73,3,32,52,64,"ECE","Male","NoWhite",2.7378,14,"HMCSE","ECE","OverTime"
"828","No","No",12,"No",24,12,57,33,85,28,24,57,85,"NoECE","Male","White",3.12,3,"HMCSE","NoECE","OverTime"
"829","No","No",40,"No",57,17,81,24,107,26,30,54,80,"NoECE","Male","White",3.5138,10,"HMCSE","NoECE","OverTime"
"830","Yes","No",17,"No",33,16,73,40,106,33,30,61,94,"NoECE","Female","White",3.2532,3,"HMCSE","NoECE","OverTime"
"831","No","No",15,"No",30,15,54,24,66,12,27,51,63,"NoECE","Male","White",2.9587,7,"HMCSE","NoECE","OverTime"
"832","Yes","No",41,"Yes",60,19,96,36,117,21,32,62,92,"ECE","Male","White",2.9432,7,"HMCSE","ECE","OverTime"
"833","No","No",39,"No",51,12,78,27,100,22,27,53,77,"NoECE","Female","White",2.987,13,"HMCSE","NoECE","OnTime"
